Country,Date,Cases,Deaths,Recovered,Vaccination
United States,2020-01-01,1490,52,1438,0
United States,2020-01-02,2120,74,2046,3105
United States,2020-01-03,1814,63,1751,12422
United States,2020-01-04,4368,153,4215,27949
United States,2020-01-05,314,11,303,49684
United States,2020-01-06,10101,355,9746,77626
United States,2020-01-07,3864,136,3728,111772
United States,2020-01-08,13292,468,12824,152119
United States,2020-01-09,12902,454,12448,198663
United States,2020-01-10,8595,302,8293,251400
United States,2020-01-11,19853,699,19154,310324
United States,2020-01-12,20836,733,20103,375431
United States,2020-01-13,23500,827,22673,446713
United States,2020-01-14,29910,1053,28857,524165
United States,2020-01-15,35068,1234,33834,607779
United States,2020-01-16,40544,1427,39117,697547
United States,2020-01-17,47113,1659,45454,793461
United States,2020-01-18,49882,1756,48126,895512
United States,2020-01-19,49601,1746,47855,1003690
United States,2020-01-20,58515,2060,56455,1117986
United States,2020-01-21,76057,2678,73379,1238387
United States,2020-01-22,75250,2650,72600,1364884
United States,2020-01-23,87534,3082,84452,1497463
United States,2020-01-24,91453,3220,88233,1636114
United States,2020-01-25,95080,3348,91732,1780822
United States,2020-01-26,103023,3628,99395,1931574
United States,2020-01-27,109951,3872,106079,2088356
United States,2020-01-28,112666,3967,108699,2251152
United States,2020-01-29,127124,4476,122648,2419949
United States,2020-01-30,140015,4930,135085,2594730
United States,2020-01-31,143265,5045,138220,2775478
United States,2020-02-01,156151,5499,150652,2962176
United States,2020-02-02,167440,5896,161544,3154808
United States,2020-02-03,171739,6047,165692,3353354
United States,2020-02-04,183678,6468,177210,3557796
United States,2020-02-05,192518,6779,185739,3768114
United States,2020-02-06,204173,7190,196983,3984290
United States,2020-02-07,213931,7533,206398,4206302
United States,2020-02-08,226800,7986,218814,4434130
United States,2020-02-09,246356,8675,237681,4667752
United States,2020-02-10,250791,8831,241960,4907146
United States,2020-02-11,266691,9391,257300,5152289
United States,2020-02-12,277344,9766,267578,5403158
United States,2020-02-13,295931,10421,285510,5659731
United States,2020-02-14,309671,10905,298766,5921981
United States,2020-02-15,321776,11331,310445,6189885
United States,2020-02-16,333795,11754,322041,6463417
United States,2020-02-17,346161,12190,333971,6742552
United States,2020-02-18,357402,12586,344816,7027262
United States,2020-02-19,382479,13469,369010,7317522
United States,2020-02-20,388504,13681,374823,7613303
United States,2020-02-21,408462,14384,394078,7914577
United States,2020-02-22,425292,14977,410315,8221316
United States,2020-02-23,435736,15344,420392,8533491
United States,2020-02-24,457069,16096,440973,8851072
United States,2020-02-25,472490,16639,455851,9174030
United States,2020-02-26,492272,17335,474937,9502332
United States,2020-02-27,501857,17673,484184,9835949
United States,2020-02-28,516274,18181,498093,10174848
United States,2020-02-29,536239,18884,517355,10518998
United States,2020-03-01,556245,19588,536657,10868365
United States,2020-03-02,573646,20201,553445,11222916
United States,2020-03-03,590307,20788,569519,11582618
United States,2020-03-04,603701,21259,582442,11947436
United States,2020-03-05,630241,22194,608047,12317336
United States,2020-03-06,654127,23035,631092,12692281
United States,2020-03-07,668300,23534,644766,13072237
United States,2020-03-08,688191,24235,663956,13457168
United States,2020-03-09,707727,24923,682804,13847035
United States,2020-03-10,727047,25603,701444,14241803
United States,2020-03-11,748960,26375,722585,14641433
United States,2020-03-12,767568,27030,740538,15045887
United States,2020-03-13,785845,27674,758171,15455126
United States,2020-03-14,805103,28352,776751,15869112
United States,2020-03-15,828005,29159,798846,16287804
United States,2020-03-16,851192,29975,821217,16711162
United States,2020-03-17,870659,30661,839998,17139146
United States,2020-03-18,894527,31501,863026,17571715
United States,2020-03-19,916948,32291,884657,18008826
United States,2020-03-20,940483,33120,907363,18450439
United States,2020-03-21,964425,33963,930462,18896510
United States,2020-03-22,983109,34621,948488,19346996
United States,2020-03-23,1001412,35265,966147,19801854
United States,2020-03-24,1027703,36191,991512,20261041
United States,2020-03-25,1052309,37058,1015251,20724511
United States,2020-03-26,1069615,37667,1031948,21192221
United States,2020-03-27,1104025,38879,1065146,21664124
United States,2020-03-28,1123843,39577,1084266,22140175
United States,2020-03-29,1148781,40455,1108326,22620329
United States,2020-03-30,1176387,41427,1134960,23104538
United States,2020-03-31,1194329,42059,1152270,23592756
United States,2020-04-01,1223059,43071,1179988,24084935
United States,2020-04-02,1245734,43869,1201865,24581027
United States,2020-04-03,1270619,44746,1225873,25080985
United States,2020-04-04,1293992,45569,1248423,25584760
United States,2020-04-05,1327568,46751,1280817,26092301
United States,2020-04-06,1346504,47418,1299086,26603561
United States,2020-04-07,1375936,48455,1327481,27118490
United States,2020-04-08,1393468,49072,1344396,27637036
United States,2020-04-09,1429811,50352,1379459,28159149
United States,2020-04-10,1455793,51267,1404526,28684778
United States,2020-04-11,1479209,52091,1427118,29213873
United States,2020-04-12,1504882,52995,1451887,29746380
United States,2020-04-13,1533870,54016,1479854,30282248
United States,2020-04-14,1567199,55190,1512009,30821423
United States,2020-04-15,1581025,55677,1525348,31363854
United States,2020-04-16,1616847,56938,1559909,31909487
United States,2020-04-17,1638794,57711,1581083,32458267
United States,2020-04-18,1669452,58791,1610661,33010142
United States,2020-04-19,1696555,59745,1636810,33565055
United States,2020-04-20,1723962,60711,1663251,34122954
United States,2020-04-21,1753496,61751,1691745,34683782
United States,2020-04-22,1778069,62616,1715453,35247483
United States,2020-04-23,1813661,63869,1749792,35814003
United States,2020-04-24,1832885,64546,1768339,36383284
United States,2020-04-25,1869313,65829,1803484,36955271
United States,2020-04-26,1895279,66744,1828535,37529906
United States,2020-04-27,1921446,67665,1853781,38107132
United States,2020-04-28,1955079,68850,1886229,38686892
United States,2020-04-29,1978465,69673,1908792,39269128
United States,2020-04-30,2013079,70892,1942187,39853781
United States,2020-05-01,2037684,71759,1965925,40440793
United States,2020-05-02,2073479,73019,2000460,41030106
United States,2020-05-03,2098563,73903,2024660,41621660
United States,2020-05-04,2129908,75006,2054902,42215395
United States,2020-05-05,2162256,76146,2086110,42811253
United States,2020-05-06,2188710,77077,2111633,43409173
United States,2020-05-07,2221158,78220,2142938,44009094
United States,2020-05-08,2246518,79113,2167405,44610957
United States,2020-05-09,2283888,80429,2203459,45214701
United States,2020-05-10,2318002,81630,2236372,45820263
United States,2020-05-11,2351850,82822,2269028,46427584
United States,2020-05-12,2373440,83583,2289857,47036601
United States,2020-05-13,2406359,84742,2321617,47647252
United States,2020-05-14,2428544,85523,2343021,48259475
United States,2020-05-15,2470174,86989,2383185,48873208
United States,2020-05-16,2498603,87990,2410613,49488389
United States,2020-05-17,2525333,88932,2436401,50104953
United States,2020-05-18,2561996,90223,2471773,50722838
United States,2020-05-19,2588086,91142,2496944,51341981
United States,2020-05-20,2618498,92213,2526285,51962319
United States,2020-05-21,2652728,93418,2559310,52583786
United States,2020-05-22,2678828,94337,2584491,53206319
United States,2020-05-23,2716970,95680,2621290,53829854
United States,2020-05-24,2741380,96540,2644840,54454327
United States,2020-05-25,2772729,97644,2675085,55079672
United States,2020-05-26,2804562,98765,2705797,55705825
United States,2020-05-27,2841491,100066,2741425,56332720
United States,2020-05-28,2868372,101012,2767360,56960293
United States,2020-05-29,2897417,102035,2795382,57588478
United States,2020-05-30,2931366,103231,2828135,58217209
United States,2020-05-31,2964779,104407,2860372,58846421
United States,2020-06-01,2992509,105384,2887125,59476047
United States,2020-06-02,3024156,106498,2917658,60106021
United States,2020-06-03,3066519,107990,2958529,60736277
United States,2020-06-04,3088254,108756,2979498,61366748
United States,2020-06-05,3121610,109930,3011680,61997368
United States,2020-06-06,3153045,111037,3042008,62628070
United States,2020-06-07,3184445,112143,3072302,63258787
United States,2020-06-08,3219473,113377,3106096,63889452
United States,2020-06-09,3252123,114526,3137597,64519997
United States,2020-06-10,3279530,115492,3164038,65150356
United States,2020-06-11,3307994,116494,3191500,65780461
United States,2020-06-12,3347831,117897,3229934,66410244
United States,2020-06-13,3374803,118847,3255956,67039637
United States,2020-06-14,3412327,120168,3292159,67668573
United States,2020-06-15,3430620,120812,3309808,68296984
United States,2020-06-16,3470123,122203,3347920,68924802
United States,2020-06-17,3507215,123510,3383705,69551959
United States,2020-06-18,3531045,124349,3406696,70178386
United States,2020-06-19,3562778,125466,3437312,70804015
United States,2020-06-20,3595767,126628,3469139,71428778
United States,2020-06-21,3624155,127628,3496527,72052606
United States,2020-06-22,3656137,128754,3527383,72675431
United States,2020-06-23,3687162,129847,3557315,73297185
United States,2020-06-24,3717255,130906,3586349,73917798
United States,2020-06-25,3754389,132214,3622175,74537202
United States,2020-06-26,3782773,133214,3649559,75155328
United States,2020-06-27,3812932,134276,3678656,75772108
United States,2020-06-28,3845563,135425,3710138,76387472
United States,2020-06-29,3872720,136381,3736339,77001352
United States,2020-06-30,3901662,137401,3764261,77613678
United States,2020-07-01,3932777,138496,3794281,78224383
United States,2020-07-02,3965239,139640,3825599,78833397
United States,2020-07-03,3992099,140585,3851514,79440651
United States,2020-07-04,4024229,141717,3882512,80046075
United States,2020-07-05,4054359,142778,3911581,80649602
United States,2020-07-06,4093183,144145,3949038,81251163
United States,2020-07-07,4106950,144630,3962320,81850687
United States,2020-07-08,4145411,145984,3999427,82448107
United States,2020-07-09,4181481,147255,4034226,83043353
United States,2020-07-10,4205823,148112,4057711,83636357
United States,2020-07-11,4237447,149226,4088221,84227049
United States,2020-07-12,4264697,150185,4114512,84815361
United States,2020-07-13,4291447,151127,4140320,85401224
United States,2020-07-14,4315398,151971,4163427,85984570
United States,2020-07-15,4352531,153278,4199253,86565329
United States,2020-07-16,4378181,154182,4223999,87143433
United States,2020-07-17,4406860,155192,4251668,87718813
United States,2020-07-18,4436477,156235,4280242,88291401
United States,2020-07-19,4472380,157499,4314881,88861128
United States,2020-07-20,4502892,158574,4344318,89427926
United States,2020-07-21,4523827,159311,4364516,89991727
United States,2020-07-22,4549592,160218,4389374,90552462
United States,2020-07-23,4575098,161116,4413982,91110064
United States,2020-07-24,4608249,162284,4445965,91664464
United States,2020-07-25,4640137,163407,4476730,92215594
United States,2020-07-26,4660787,164134,4496653,92763386
United States,2020-07-27,4680930,164843,4516087,93307774
United States,2020-07-28,4718047,166150,4551897,93848688
United States,2020-07-29,4745936,167133,4578803,94386062
United States,2020-07-30,4764089,167772,4596317,94919829
United States,2020-07-31,4796402,168910,4627492,95449920
United States,2020-08-01,4823602,169868,4653734,95976270
United States,2020-08-02,4847966,170726,4677240,96498810
United States,2020-08-03,4871495,171554,4699941,97017475
United States,2020-08-04,4903181,172670,4730511,97532197
United States,2020-08-05,4923988,173403,4750585,98042910
United States,2020-08-06,4945707,174168,4771539,98549548
United States,2020-08-07,4968930,174986,4793944,99052045
United States,2020-08-08,5004767,176248,4828519,99550334
United States,2020-08-09,5027300,177041,4850259,100044350
United States,2020-08-10,5049997,177840,4872157,100534027
United States,2020-08-11,5072474,178632,4893842,101019299
United States,2020-08-12,5096182,179467,4916715,101500102
United States,2020-08-13,5118145,180240,4937905,101976371
United States,2020-08-14,5143820,181144,4962676,102448039
United States,2020-08-15,5161539,181768,4979771,102915044
United States,2020-08-16,5189190,182742,5006448,103377319
United States,2020-08-17,5213427,183596,5029831,103834802
United States,2020-08-18,5239061,184498,5054563,104287428
United States,2020-08-19,5259249,185209,5074040,104735134
United States,2020-08-20,5284100,186085,5098015,105177855
United States,2020-08-21,5307770,186918,5120852,105615528
United States,2020-08-22,5328385,187644,5140741,106048091
United States,2020-08-23,5347759,188326,5159433,106475481
United States,2020-08-24,5367297,189014,5178283,106897635
United States,2020-08-25,5384801,189631,5195170,107314490
United States,2020-08-26,5411017,190554,5220463,107725985
United States,2020-08-27,5434377,191377,5243000,108132058
United States,2020-08-28,5449923,191924,5257999,108532647
United States,2020-08-29,5474832,192801,5282031,108927692
United States,2020-08-30,5482850,193084,5289766,109317131
United States,2020-08-31,5503210,193801,5309409,109700903
United States,2020-09-01,5528703,194699,5334004,110078948
United States,2020-09-02,5545299,195283,5350016,110451207
United States,2020-09-03,5567032,196048,5370984,110817618
United States,2020-09-04,5580595,196526,5384069,111178124
United States,2020-09-05,5595437,197049,5398388,111532664
United States,2020-09-06,5614964,197736,5417228,111881180
United States,2020-09-07,5627654,198183,5429471,112223613
United States,2020-09-08,5645740,198820,5446920,112559906
United States,2020-09-09,5669132,199644,5469488,112890000
United States,2020-09-10,5684925,200200,5484725,113213837
United States,2020-09-11,5699045,200697,5498348,113531361
United States,2020-09-12,5707634,201000,5506634,113842514
United States,2020-09-13,5727310,201693,5525617,114147241
United States,2020-09-14,5739282,202114,5537168,114445484
United States,2020-09-15,5761744,202905,5558839,114737189
United States,2020-09-16,5770100,203200,5566900,115022299
United States,2020-09-17,5782287,203629,5578658,115300760
United States,2020-09-18,5799492,204235,5595257,115572517
United States,2020-09-19,5810448,204620,5605828,115837516
United States,2020-09-20,5830311,205320,5624991,116095702
United States,2020-09-21,5835455,205501,5629954,116347023
United States,2020-09-22,5845398,205851,5639547,116591424
United States,2020-09-23,5854695,206179,5648516,116828853
United States,2020-09-24,5873160,206829,5666331,117059259
United States,2020-09-25,5882487,207157,5675330,117282588
United States,2020-09-26,5890346,207434,5682912,117498789
United States,2020-09-27,5909380,208104,5701276,117707811
United States,2020-09-28,5917659,208396,5709263,117909604
United States,2020-09-29,5924999,208654,5716345,118104116
United States,2020-09-30,5938882,209143,5729739,118291299
United States,2020-10-01,5945464,209375,5736089,118471102
United States,2020-10-02,5949080,209503,5739577,118643477
United States,2020-10-03,5956522,209765,5746757,118808374
United States,2020-10-04,5970450,210255,5760195,118965747
United States,2020-10-05,5976456,210467,5765989,119115546
United States,2020-10-06,5982726,210687,5772039,119257725
United States,2020-10-07,5985997,210803,5775194,119392237
United States,2020-10-08,5997061,211192,5785869,119519036
United States,2020-10-09,5998409,211240,5787169,119638075
United States,2020-10-10,6006042,211508,5794534,119749310
United States,2020-10-11,6016246,211868,5804378,119852695
United States,2020-10-12,6013950,211787,5802163,119948185
United States,2020-10-13,6015215,211832,5803383,120035737
United States,2020-10-14,6020821,212029,5808792,120115308
United States,2020-10-15,6031079,212390,5818689,120186853
United States,2020-10-16,6031709,212412,5819297,120250332
United States,2020-10-17,6033111,212462,5820649,120305700
United States,2020-10-18,6034117,212497,5821620,120352918
United States,2020-10-19,6039262,212678,5826584,120391943
United States,2020-10-20,6036286,212574,5823712,120422736
United States,2020-10-21,6041136,212744,5828392,120445255
United States,2020-10-22,6038315,212645,5825670,120459463
United States,2020-10-23,6037957,212632,5825325,120465319
United States,2020-10-24,6038591,212655,5825936,120462785
United States,2020-10-25,6038810,212662,5826148,120451823
United States,2020-10-26,6038818,212663,5826155,120432396
United States,2020-10-27,6038260,212643,5825617,120404466
United States,2020-10-28,6023346,212118,5811228,120367997
United States,2020-10-29,6030526,212371,5818155,120322954
United States,2020-10-30,6029117,212321,5816796,120269301
United States,2020-10-31,6032176,212429,5819747,120207003
United States,2020-11-01,6019966,211999,5807967,120136026
United States,2020-11-02,6019990,212000,5807990,120056337
United States,2020-11-03,6019873,211996,5807877,119967901
United States,2020-11-04,6005612,211493,5794119,119870687
United States,2020-11-05,6005854,211502,5794352,119764662
United States,2020-11-06,5996044,211156,5784888,119649796
United States,2020-11-07,5990735,210969,5779766,119526056
United States,2020-11-08,5983008,210697,5772311,119393414
United States,2020-11-09,5976057,210453,5765604,119251838
United States,2020-11-10,5979853,210586,5769267,119101301
United States,2020-11-11,5965553,210083,5755470,118941772
United States,2020-11-12,5957868,209812,5748056,118773225
United States,2020-11-13,5946861,209424,5737437,118595631
United States,2020-11-14,5930472,208847,5721625,118408965
United States,2020-11-15,5927197,208732,5718465,118213199
United States,2020-11-16,5919086,208446,5710640,118008308
United States,2020-11-17,5901897,207841,5694056,117794267
United States,2020-11-18,5896645,207656,5688989,117571052
United States,2020-11-19,5884048,207212,5676836,117338638
United States,2020-11-20,5875653,206917,5668736,117097002
United States,2020-11-21,5855484,206206,5649278,116846122
United States,2020-11-22,5840113,205665,5634448,116585976
United States,2020-11-23,5828965,205273,5623692,116316542
United States,2020-11-24,5820863,204987,5615876,116037799
United States,2020-11-25,5795542,204096,5591446,115749727
United States,2020-11-26,5779763,203540,5576223,115452307
United States,2020-11-27,5771451,203247,5568204,115145519
United States,2020-11-28,5753768,202624,5551144,114829346
United States,2020-11-29,5738865,202100,5536765,114503769
United States,2020-11-30,5725103,201615,5523488,114168772
United States,2020-12-01,5702808,200830,5501978,113824337
United States,2020-12-02,5680628,200049,5480579,113470450
United States,2020-12-03,5675312,199861,5475451,113107095
United States,2020-12-04,5646486,198846,5447640,112734257
United States,2020-12-05,5627049,198162,5428887,112351923
United States,2020-12-06,5614499,197720,5416779,111960079
United States,2020-12-07,5589389,196836,5392553,111558712
United States,2020-12-08,5569790,196145,5373645,111147812
United States,2020-12-09,5550459,195465,5354994,110727366
United States,2020-12-10,5530831,194773,5336058,110297363
United States,2020-12-11,5504045,193830,5310215,109857794
United States,2020-12-12,5487606,193251,5294355,109408650
United States,2020-12-13,5452451,192013,5260438,108949921
United States,2020-12-14,5438502,191522,5246980,108481600
United States,2020-12-15,5409195,190490,5218705,108003679
United States,2020-12-16,5392023,189885,5202138,107516151
United States,2020-12-17,5362976,188862,5174114,107019011
United States,2020-12-18,5334823,187871,5146952,106512253
United States,2020-12-19,5313307,187113,5126194,105995873
United States,2020-12-20,5287652,186210,5101442,105469865
United States,2020-12-21,5259920,185233,5074687,104934228
United States,2020-12-22,5227006,184074,5042932,104388957
United States,2020-12-23,5200949,183156,5017793,103834052
United States,2020-12-24,5174192,182214,4991978,103269511
United States,2020-12-25,5145242,181195,4964047,102695332
United States,2020-12-26,5118552,180255,4938297,102111517
United States,2020-12-27,5079610,178883,4900727,101518065
United States,2020-12-28,5057114,178091,4879023,100914979
United States,2020-12-29,5024293,176935,4847358,100302259
United States,2020-12-30,4991242,175771,4815471,99679909
United States,2020-12-31,4959843,174666,4785177,99047933
United States,2021-01-01,4929393,173593,4755800,98406333
United States,2021-01-02,4885505,172048,4713457,97755116
United States,2021-01-03,4861944,171218,4690726,97094286
United States,2021-01-04,4827726,170013,4657713,96423849
United States,2021-01-05,4798269,168976,4629293,95743813
United States,2021-01-06,4759240,167601,4591639,95054185
United States,2021-01-07,4726117,166435,4559682,94354973
United States,2021-01-08,4696377,165387,4530990,93646186
United States,2021-01-09,4658528,164054,4494474,92927833
United States,2021-01-10,4621711,162758,4458953,92199925
United States,2021-01-11,4580080,161292,4418788,91462473
United States,2021-01-12,4546065,160094,4385971,90715489
United States,2021-01-13,4505552,158667,4346885,89958984
United States,2021-01-14,4467259,157319,4309940,89192971
United States,2021-01-15,4430373,156020,4274353,88417466
United States,2021-01-16,4387675,154516,4233159,87632481
United States,2021-01-17,4354754,153357,4201397,86838032
United States,2021-01-18,4308971,151744,4157227,86034135
United States,2021-01-19,4270765,150399,4120366,85220807
United States,2021-01-20,4232284,149044,4083240,84398064
United States,2021-01-21,4189158,147525,4041633,83565925
United States,2021-01-22,4138888,145755,3993133,82724407
United States,2021-01-23,4102365,144469,3957896,81873531
United States,2021-01-24,4060583,142997,3917586,81013317
United States,2021-01-25,4017128,141467,3875661,80143784
United States,2021-01-26,3966435,139682,3826753,79264955
United States,2021-01-27,3923425,138167,3785258,78376852
United States,2021-01-28,3883910,136775,3747135,77479497
United States,2021-01-29,3832654,134970,3697684,76572913
United States,2021-01-30,3788280,133408,3654872,75657126
United States,2021-01-31,3748127,131994,3616133,74732159
United States,2021-02-01,3695933,130156,3565777,73798038
United States,2021-02-02,3646411,128412,3517999,72854790
United States,2021-02-03,3598182,126713,3471469,71902442
United States,2021-02-04,3554005,125157,3428848,70941021
United States,2021-02-05,3499855,123251,3376604,69970555
United States,2021-02-06,3454364,121649,3332715,68991074
United States,2021-02-07,3406751,119972,3286779,68002607
United States,2021-02-08,3359966,118324,3241642,67005185
United States,2021-02-09,3307447,116475,3190972,65998838
United States,2021-02-10,3252002,114522,3137480,64983599
United States,2021-02-11,3206951,112936,3094015,63959500
United States,2021-02-12,3150303,110941,3039362,62926574
United States,2021-02-13,3095009,108993,2986016,61884855
United States,2021-02-14,3045897,107264,2938633,60834377
United States,2021-02-15,2998158,105583,2892575,59775177
United States,2021-02-16,2940442,103550,2836892,58707289
United States,2021-02-17,2886002,101633,2784369,57630750
United States,2021-02-18,2837015,99908,2737107,56545597
United States,2021-02-19,2772064,97621,2674443,55451870
United States,2021-02-20,2717327,95693,2621634,54349605
United States,2021-02-21,2660589,93695,2566894,53238843
United States,2021-02-22,2611104,91952,2519152,52119623
United States,2021-02-23,2553935,89939,2463996,50991986
United States,2021-02-24,2501585,88095,2413490,49855974
United States,2021-02-25,2439962,85925,2354037,48711628
United States,2021-02-26,2380082,83817,2296265,47558991
United States,2021-02-27,2323278,81816,2241462,46398107
United States,2021-02-28,2265104,79767,2185337,45229019
United States,2021-03-01,2200216,77482,2122734,44051772
United States,2021-03-02,2155350,75902,2079448,42866412
United States,2021-03-03,2088327,73542,2014785,41672985
United States,2021-03-04,2027127,71387,1955740,40471537
United States,2021-03-05,1967896,69301,1898595,39262115
United States,2021-03-06,1907240,67165,1840075,38044768
United States,2021-03-07,1843066,64905,1778161,36819545
United States,2021-03-08,1779690,62673,1717017,35586494
United States,2021-03-09,1721623,60628,1660995,34345666
United States,2021-03-10,1658389,58401,1599988,33097111
United States,2021-03-11,1591522,56047,1535475,31840880
United States,2021-03-12,1535610,54078,1481532,30577026
United States,2021-03-13,1468215,51704,1416511,29305601
United States,2021-03-14,1405617,49500,1356117,28026658
United States,2021-03-15,1343392,47308,1296084,26740251
United States,2021-03-16,1274071,44867,1229204,25446434
United States,2021-03-17,1209894,42607,1167287,24145263
United States,2021-03-18,1146008,40357,1105651,22836794
United States,2021-03-19,1075049,37858,1037191,21521083
United States,2021-03-20,1011389,35617,975772,20198186
United States,2021-03-21,945032,33280,911752,18868162
United States,2021-03-22,874505,30796,843709,17531068
United States,2021-03-23,818044,28808,789236,16186965
United States,2021-03-24,738071,25991,712080,14835910
United States,2021-03-25,670444,23610,646834,13477965
United States,2021-03-26,610763,21508,589255,12113189
United States,2021-03-27,540107,19020,521087,10741645
United States,2021-03-28,465349,16387,448962,9363395
United States,2021-03-29,401423,14136,387287,7978500
United States,2021-03-30,334610,11783,322827,6587025
United States,2021-03-31,259665,9144,250521,5189032
United States,2021-04-01,198058,6974,191084,3784587
United States,2021-04-02,113122,3983,109139,2373753
United States,2021-04-03,50183,1767,48416,956598
United States,2021-04-04,19506,686,18820,466813
United States,2021-04-05,91981,3239,88742,1896414
United States,2021-04-06,167477,5897,161580,3332137
United States,2021-04-07,239934,8449,231485,4773914
United States,2021-04-08,309972,10915,299057,6221677
United States,2021-04-09,381507,13435,368072,7675356
United States,2021-04-10,455270,16032,439238,9134883
United States,2021-04-11,527167,18564,508603,10600187
United States,2021-04-12,607612,21397,586215,12071197
United States,2021-04-13,678904,23908,654996,13547841
United States,2021-04-14,755450,26603,728847,15030049
United States,2021-04-15,828079,29161,798918,16517748
United States,2021-04-16,898173,31630,866543,18010864
United States,2021-04-17,976175,34377,941798,19509324
United States,2021-04-18,1043165,36736,1006429,21013055
United States,2021-04-19,1126675,39677,1086998,22521981
United States,2021-04-20,1202894,42361,1160533,24036028
United States,2021-04-21,1278768,45033,1233735,25555120
United States,2021-04-22,1357506,47805,1309701,27079180
United States,2021-04-23,1432106,50433,1381673,28608132
United States,2021-04-24,1504941,52998,1451943,30141900
United States,2021-04-25,1585293,55827,1529466,31680404
United States,2021-04-26,1665524,58653,1606871,33223568
United States,2021-04-27,1743416,61396,1682020,34771311
United States,2021-04-28,1819525,64076,1755449,36323556
United States,2021-04-29,1895691,66758,1828933,37880222
United States,2021-04-30,1970103,69379,1900724,39441228
United States,2021-05-01,2056820,72433,1984387,41006495
United States,2021-05-02,2131980,75079,2056901,42575941
United States,2021-05-03,2209185,77798,2131387,44149485
United States,2021-05-04,2294675,80809,2213866,45727044
United States,2021-05-05,2370503,83479,2287024,47308535
United States,2021-05-06,2449324,86255,2363069,48893876
United States,2021-05-07,2529225,89069,2440156,50482983
United States,2021-05-08,2605656,91760,2513896,52075771
United States,2021-05-09,2686703,94615,2592088,53672157
United States,2021-05-10,2768064,97480,2670584,55272055
United States,2021-05-11,2845035,100190,2744845,56875381
United States,2021-05-12,2921140,102870,2818270,58482048
United States,2021-05-13,3001971,105717,2896254,60091969
United States,2021-05-14,3094473,108975,2985498,61705059
United States,2021-05-15,3167064,111531,3055533,63321230
United States,2021-05-16,3250577,114472,3136105,64940394
United States,2021-05-17,3330632,117291,3213341,66562464
United States,2021-05-18,3413763,120219,3293544,68187351
United States,2021-05-19,3493489,123026,3370463,69814967
United States,2021-05-20,3574943,125895,3449048,71445221
United States,2021-05-21,3659052,128857,3530195,73078025
United States,2021-05-22,3741917,131775,3610142,74713289
United States,2021-05-23,3822367,134608,3687759,76350922
United States,2021-05-24,3902152,137418,3764734,77990833
United States,2021-05-25,3983099,140268,3842831,79632931
United States,2021-05-26,4064514,143136,3921378,81277124
United States,2021-05-27,4151332,146193,4005139,82923322
United States,2021-05-28,4231209,149006,4082203,84571430
United States,2021-05-29,4311505,151834,4159671,86221358
United States,2021-05-30,4393460,154720,4238740,87873011
United States,2021-05-31,4480222,157775,4322447,89526297
United States,2021-06-01,4563543,160709,4402834,91181121
United States,2021-06-02,4645036,163579,4481457,92837390
United States,2021-06-03,4732397,166656,4565741,94495009
United States,2021-06-04,4812218,169467,4642751,96153883
United States,2021-06-05,4892155,172282,4719873,97813918
United States,2021-06-06,4975589,175220,4800369,99475018
United States,2021-06-07,5061751,178254,4883497,101137088
United States,2021-06-08,5143322,181127,4962195,102800031
United States,2021-06-09,5229996,184179,5045817,104463751
United States,2021-06-10,5308195,186933,5121262,106128152
United States,2021-06-11,5394066,189957,5204109,107793136
United States,2021-06-12,5478031,192914,5285117,109458608
United States,2021-06-13,5561643,195859,5365784,111124468
United States,2021-06-14,5643995,198759,5445236,112790619
United States,2021-06-15,5728620,201739,5526881,114456964
United States,2021-06-16,5808313,204545,5603768,116123404
United States,2021-06-17,5895154,207603,5687551,117789840
United States,2021-06-18,5971920,210307,5761613,119456174
United States,2021-06-19,6055680,213257,5842423,121122307
United States,2021-06-20,6146802,216466,5930336,122788140
United States,2021-06-21,6226920,219287,6007633,124453572
United States,2021-06-22,6312579,222304,6090275,126118504
United States,2021-06-23,6394751,225197,6169554,127782837
United States,2021-06-24,6470250,227856,6242394,129446470
United States,2021-06-25,6561063,231054,6330009,131109302
United States,2021-06-26,6641974,233904,6408070,132771233
United States,2021-06-27,6724445,236808,6487637,134432162
United States,2021-06-28,6812564,239911,6572653,136091989
United States,2021-06-29,6895036,242815,6652221,137750611
United States,2021-06-30,6979086,245775,6733311,139407928
United States,2021-07-01,7060843,248654,6812189,141063838
United States,2021-07-02,7150085,251797,6898288,142718239
United States,2021-07-03,7221508,254312,6967196,144371029
United States,2021-07-04,7299084,257044,7042040,146022106
United States,2021-07-05,7387876,260171,7127705,147671368
United States,2021-07-06,7475438,263255,7212183,149318713
United States,2021-07-07,7555161,266062,7289099,150964038
United States,2021-07-08,7636729,268935,7367794,152607239
United States,2021-07-09,7720642,271890,7448752,154248216
United States,2021-07-10,7796374,274557,7521817,155886863
United States,2021-07-11,7878364,277444,7600920,157523079
United States,2021-07-12,7966568,280550,7686018,159156761
United States,2021-07-13,8041908,283204,7758704,160787804
United States,2021-07-14,8120682,285978,7834704,162416106
United States,2021-07-15,8200722,288796,7911926,164041563
United States,2021-07-16,8278671,291541,7987130,165664072
United States,2021-07-17,8372124,294833,8077291,167283528
United States,2021-07-18,8440614,297244,8143370,168899828
United States,2021-07-19,8531795,300456,8231339,170512869
United States,2021-07-20,8613075,303318,8309757,172122546
United States,2021-07-21,8690349,306039,8384310,173728756
United States,2021-07-22,8773496,308967,8464529,175331394
United States,2021-07-23,8850203,311669,8538534,176930356
United States,2021-07-24,8935657,314678,8620979,178525539
United States,2021-07-25,9011647,317354,8694293,180116838
United States,2021-07-26,9085971,319971,8766000,181704149
United States,2021-07-27,9169579,322916,8846663,183287368
United States,2021-07-28,9247875,325673,8922202,184866391
United States,2021-07-29,9325508,328407,8997101,186441113
United States,2021-07-30,9401723,331091,9070632,188011431
United States,2021-07-31,9489367,334177,9155190,189577240
United States,2021-08-01,9560013,336665,9223348,191138435
United States,2021-08-02,9640658,339505,9301153,192694914
United States,2021-08-03,9716800,342187,9374613,194246571
United States,2021-08-04,9791177,344806,9446371,195793303
United States,2021-08-05,9875721,347783,9527938,197335005
United States,2021-08-06,9951945,350468,9601477,198871574
United States,2021-08-07,10031561,353271,9678290,200402905
United States,2021-08-08,10103267,355797,9747470,201928895
United States,2021-08-09,10173067,358255,9814812,203449439
United States,2021-08-10,10253614,361091,9892523,204964434
United States,2021-08-11,10333110,363891,9969219,206473776
United States,2021-08-12,10405454,366438,10039016,207977362
United States,2021-08-13,10483649,369192,10114457,209475087
United States,2021-08-14,10557028,371776,10185252,210966849
United States,2021-08-15,10626292,374215,10252077,212452543
United States,2021-08-16,10705431,377002,10328429,213932067
United States,2021-08-17,10771514,379330,10392184,215405318
United States,2021-08-18,10848765,382050,10466715,216872192
United States,2021-08-19,10921254,384603,10536651,218332587
United States,2021-08-20,10995137,387205,10607932,219786399
United States,2021-08-21,11064001,389630,10674371,221233527
United States,2021-08-22,11135970,392164,10743806,222673867
United States,2021-08-23,11209112,394740,10814372,224107317
United States,2021-08-24,11279660,397224,10882436,225533775
United States,2021-08-25,11353184,399814,10953370,226953139
United States,2021-08-26,11421280,402212,11019068,228365307
United States,2021-08-27,11494420,404787,11089633,229770178
United States,2021-08-28,11563151,407208,11155943,231167649
United States,2021-08-29,11633548,409687,11223861,232557620
United States,2021-08-30,11703253,412142,11291111,233939989
United States,2021-08-31,11772735,414589,11358146,235314656
United States,2021-09-01,11837230,416860,11420370,236681519
United States,2021-09-02,11902368,419154,11483214,238040478
United States,2021-09-03,11970357,421548,11548809,239391434
United States,2021-09-04,12045515,424195,11621320,240734285
United States,2021-09-05,12103799,426247,11677552,242068932
United States,2021-09-06,12175415,428769,11746646,243395276
United States,2021-09-07,12238248,430982,11807266,244713216
United States,2021-09-08,12308685,433463,11875222,246022655
United States,2021-09-09,12370234,435630,11934604,247323492
United States,2021-09-10,12434248,437884,11996364,248615631
United States,2021-09-11,12504343,440353,12063990,249898971
United States,2021-09-12,12561113,442352,12118761,251173416
United States,2021-09-13,12621919,444493,12177426,252438868
United States,2021-09-14,12689744,446882,12242862,253695228
United States,2021-09-15,12746996,448898,12298098,254942400
United States,2021-09-16,12813994,451258,12362736,256180288
United States,2021-09-17,12871952,453299,12418653,257408794
United States,2021-09-18,12943031,455802,12487229,258627822
United States,2021-09-19,12988126,457390,12530736,259837277
United States,2021-09-20,13051142,459609,12591533,261037063
United States,2021-09-21,13116506,461911,12654595,262227084
United States,2021-09-22,13181071,464185,12716886,263407246
United States,2021-09-23,13232070,465981,12766089,264577455
United States,2021-09-24,13295780,468224,12827556,265737615
United States,2021-09-25,13346999,470028,12876971,266887634
United States,2021-09-26,13404067,472038,12932029,268027418
United States,2021-09-27,13464986,474183,12990803,269156873
United States,2021-09-28,13514079,475912,13038167,270275907
United States,2021-09-29,13570517,477899,13092618,271384428
United States,2021-09-30,13624816,479812,13145004,272482344
United States,2021-10-01,13682344,481837,13200507,273569563
United States,2021-10-02,13740847,483898,13256949,274645994
United States,2021-10-03,13786168,485494,13300674,275711546
United States,2021-10-04,13842995,487495,13355500,276766130
United States,2021-10-05,13898841,489462,13409379,277809654
United States,2021-10-06,13941349,490959,13450390,278842031
United States,2021-10-07,13989897,492668,13497229,279863170
United States,2021-10-08,14047437,494695,13552742,280872983
United States,2021-10-09,14090038,496195,13593843,281871383
United States,2021-10-10,14146191,498172,13648019,282858281
United States,2021-10-11,14196481,499943,13696538,283833590
United States,2021-10-12,14245453,501668,13743785,284797223
United States,2021-10-13,14285503,503078,13782425,285749095
United States,2021-10-14,14340467,505014,13835453,286689118
United States,2021-10-15,14381818,506470,13875348,287617209
United States,2021-10-16,14431867,508233,13923634,288533282
United States,2021-10-17,14476700,509812,13966888,289437253
United States,2021-10-18,14516316,511207,14005109,290329038
United States,2021-10-19,14564921,512918,14052003,291208554
United States,2021-10-20,14608321,514447,14093874,292075717
United States,2021-10-21,14645928,515771,14130157,292930446
United States,2021-10-22,14686461,517198,14169263,293772659
United States,2021-10-23,14731055,518769,14212286,294602275
United States,2021-10-24,14776162,520357,14255805,295419212
United States,2021-10-25,14815853,521755,14294098,296223391
United States,2021-10-26,14853424,523078,14330346,297014732
United States,2021-10-27,14891506,524419,14367087,297793156
United States,2021-10-28,14934068,525918,14408150,298558584
United States,2021-10-29,14965980,527042,14438938,299310939
United States,2021-10-30,15005009,528416,14476593,300050143
United States,2021-10-31,15047227,529903,14517324,300776120
United States,2021-11-01,15080214,531065,14549149,301488792
United States,2021-11-02,15113730,532245,14581485,302188085
United States,2021-11-03,15146551,533401,14613150,302873924
United States,2021-11-04,15173629,534355,14639274,303546233
United States,2021-11-05,15211986,535705,14676281,304204940
United States,2021-11-06,15247765,536965,14710800,304849970
United States,2021-11-07,15275772,537952,14737820,305481252
United States,2021-11-08,15308497,539104,14769393,306098713
United States,2021-11-09,15336391,540086,14796305,306702282
United States,2021-11-10,15364980,541093,14823887,307291888
United States,2021-11-11,15391634,542032,14849602,307867462
United States,2021-11-12,15423746,543163,14880583,308428932
United States,2021-11-13,15445561,543931,14901630,308976232
United States,2021-11-14,15474588,544953,14929635,309509292
United States,2021-11-15,15505828,546053,14959775,310028045
United States,2021-11-16,15521346,546600,14974746,310532425
United States,2021-11-17,15552030,547680,15004350,311022364
United States,2021-11-18,15579603,548651,15030952,311497798
United States,2021-11-19,15594366,549171,15045195,311958662
United States,2021-11-20,15615226,549906,15065320,312404891
United States,2021-11-21,15643743,550910,15092833,312836422
United States,2021-11-22,15666094,551697,15114397,313253192
United States,2021-11-23,15685049,552365,15132684,313655140
United States,2021-11-24,15701421,552941,15148480,314042203
United States,2021-11-25,15718117,553529,15164588,314414321
United States,2021-11-26,15738268,554239,15184029,314771434
United States,2021-11-27,15756876,554894,15201982,315113483
United States,2021-11-28,15768555,555306,15213249,315440410
United States,2021-11-29,15790090,556064,15234026,315752156
United States,2021-11-30,15800422,556428,15243994,316048664
United States,2021-12-01,15818803,557075,15261728,316329878
United States,2021-12-02,15829670,557458,15272212,316595743
United States,2021-12-03,15843949,557961,15285988,316846204
United States,2021-12-04,15855462,558366,15297096,317081206
United States,2021-12-05,15867455,558788,15308667,317300696
United States,2021-12-06,15871905,558945,15312960,317504621
United States,2021-12-07,15888152,559517,15328635,317692931
United States,2021-12-08,15896762,559820,15336942,317865573
United States,2021-12-09,15895092,559762,15335330,318022497
United States,2021-12-10,15905888,560142,15345746,318163654
United States,2021-12-11,15923241,560753,15362488,318288995
United States,2021-12-12,15922645,560732,15361913,318398472
United States,2021-12-13,15931404,561040,15370364,318492039
United States,2021-12-14,15932388,561075,15371313,318569647
United States,2021-12-15,15942665,561437,15381228,318631253
United States,2021-12-16,15934962,561166,15373796,318676811
United States,2021-12-17,15939716,561333,15378383,318706276
United States,2021-12-18,15936359,561215,15375144,318719607
United States,2021-12-19,15941749,561405,15380344,318716761
United States,2021-12-20,15935097,561170,15373927,318697696
United States,2021-12-21,15934934,561165,15373769,318662371
United States,2021-12-22,15925963,560849,15365114,318610746
United States,2021-12-23,15922820,560738,15362082,318542783
United States,2021-12-24,15920631,560661,15359970,318458443
United States,2021-12-25,15919229,560612,15358617,318357689
United States,2021-12-26,15905672,560134,15345538,318240484
United States,2021-12-27,15910655,560310,15350345,318106793
United States,2021-12-28,15902606,560026,15342580,317956580
United States,2021-12-29,15889855,559577,15330278,317789811
United States,2021-12-30,15872905,558980,15313925,317606454
United States,2021-12-31,15870993,558913,15312080,317406477
Brazil,2020-01-01,2097,38,2059,0
Brazil,2020-01-02,2279,42,2237,1994
Brazil,2020-01-03,2083,38,2045,7977
Brazil,2020-01-04,5278,97,5181,17948
Brazil,2020-01-05,1122,20,1102,31905
Brazil,2020-01-06,1345,24,1321,49849
Brazil,2020-01-07,5090,93,4997,71776
Brazil,2020-01-08,7243,133,7110,97686
Brazil,2020-01-09,6755,124,6631,127575
Brazil,2020-01-10,13669,252,13417,161441
Brazil,2020-01-11,13315,245,13070,199280
Brazil,2020-01-12,12819,236,12583,241089
Brazil,2020-01-13,12674,233,12441,286865
Brazil,2020-01-14,21491,396,21095,336602
Brazil,2020-01-15,24044,443,23601,390296
Brazil,2020-01-16,23888,440,23448,447943
Brazil,2020-01-17,28495,525,27970,509536
Brazil,2020-01-18,30845,568,30277,575069
Brazil,2020-01-19,35883,661,35222,644538
Brazil,2020-01-20,36404,671,35733,717935
Brazil,2020-01-21,40104,739,39365,795253
Brazil,2020-01-22,48507,894,47613,876485
Brazil,2020-01-23,53168,980,52188,961623
Brazil,2020-01-24,54719,1009,53710,1050660
Brazil,2020-01-25,58951,1087,57864,1143587
Brazil,2020-01-26,67956,1253,66703,1240395
Brazil,2020-01-27,69164,1275,67889,1341076
Brazil,2020-01-28,76162,1404,74758,1445619
Brazil,2020-01-29,81445,1501,79944,1554015
Brazil,2020-01-30,84222,1553,82669,1666253
Brazil,2020-01-31,93683,1727,91956,1782324
Brazil,2020-02-01,99600,1836,97764,1902216
Brazil,2020-02-02,106480,1963,104517,2025917
Brazil,2020-02-03,112555,2075,110480,2153417
Brazil,2020-02-04,123451,2276,121175,2284703
Brazil,2020-02-05,128262,2365,125897,2419764
Brazil,2020-02-06,132944,2451,130493,2558585
Brazil,2020-02-07,140393,2589,137804,2701154
Brazil,2020-02-08,151307,2790,148517,2847458
Brazil,2020-02-09,157019,2895,154124,2997482
Brazil,2020-02-10,160384,2957,157427,3151213
Brazil,2020-02-11,173009,3190,169819,3308636
Brazil,2020-02-12,181812,3352,178460,3469737
Brazil,2020-02-13,190970,3521,187449,3634499
Brazil,2020-02-14,195221,3600,191621,3802908
Brazil,2020-02-15,203789,3758,200031,3974948
Brazil,2020-02-16,211699,3904,207795,4150602
Brazil,2020-02-17,223439,4120,219319,4329853
Brazil,2020-02-18,233603,4307,229296,4512685
Brazil,2020-02-19,240393,4433,235960,4699080
Brazil,2020-02-20,250798,4625,246173,4889022
Brazil,2020-02-21,256525,4730,251795,5082490
Brazil,2020-02-22,274065,5054,269011,5279469
Brazil,2020-02-23,277670,5120,272550,5479937
Brazil,2020-02-24,292105,5386,286719,5683878
Brazil,2020-02-25,302300,5574,296726,5891271
Brazil,2020-02-26,312546,5763,306783,6102096
Brazil,2020-02-27,323420,5964,317456,6316335
Brazil,2020-02-28,332118,6124,325994,6533965
Brazil,2020-02-29,344733,6357,338376,6754967
Brazil,2020-03-01,358819,6617,352202,6979319
Brazil,2020-03-02,370943,6840,364103,7207001
Brazil,2020-03-03,379018,6989,372029,7437990
Brazil,2020-03-04,388419,7163,381256,7672265
Brazil,2020-03-05,402066,7414,394652,7909802
Brazil,2020-03-06,419805,7741,412064,8150581
Brazil,2020-03-07,426645,7867,418778,8394577
Brazil,2020-03-08,440433,8122,432311,8641767
Brazil,2020-03-09,456272,8414,447858,8892127
Brazil,2020-03-10,464923,8573,456350,9145634
Brazil,2020-03-11,478626,8826,469800,9402264
Brazil,2020-03-12,493756,9105,484651,9661992
Brazil,2020-03-13,508948,9385,499563,9924792
Brazil,2020-03-14,517331,9540,507791,10190641
Brazil,2020-03-15,535206,9870,525336,10459512
Brazil,2020-03-16,545342,10056,535286,10731379
Brazil,2020-03-17,557898,10288,547610,11006217
Brazil,2020-03-18,574299,10590,563709,11283998
Brazil,2020-03-19,585441,10796,574645,11564698
Brazil,2020-03-20,603181,11123,592058,11848287
Brazil,2020-03-21,623291,11494,611797,12134740
Brazil,2020-03-22,633506,11682,621824,12424028
Brazil,2020-03-23,645632,11906,633726,12716123
Brazil,2020-03-24,662928,12225,650703,13010998
Brazil,2020-03-25,673686,12423,661263,13308624
Brazil,2020-03-26,689152,12709,676443,13608973
Brazil,2020-03-27,705854,13017,692837,13912014
Brazil,2020-03-28,721580,13307,708273,14217719
Brazil,2020-03-29,734151,13538,720613,14526058
Brazil,2020-03-30,751884,13865,738019,14837002
Brazil,2020-03-31,767992,14162,753830,15150520
Brazil,2020-04-01,787467,14522,772945,15466582
Brazil,2020-04-02,797455,14706,782749,15785157
Brazil,2020-04-03,813396,15000,798396,16106214
Brazil,2020-04-04,832975,15361,817614,16429722
Brazil,2020-04-05,851428,15701,835727,16755649
Brazil,2020-04-06,866653,15982,850671,17083964
Brazil,2020-04-07,882739,16279,866460,17414635
Brazil,2020-04-08,898213,16564,881649,17747629
Brazil,2020-04-09,917108,16912,900196,18082913
Brazil,2020-04-10,934385,17231,917154,18420456
Brazil,2020-04-11,949147,17503,931644,18760223
Brazil,2020-04-12,964853,17793,947060,19102183
Brazil,2020-04-13,982150,18112,964038,19446300
Brazil,2020-04-14,1003408,18504,984904,19792542
Brazil,2020-04-15,1015749,18731,997018,20140874
Brazil,2020-04-16,1040190,19182,1021008,20491261
Brazil,2020-04-17,1053350,19425,1033925,20843671
Brazil,2020-04-18,1072769,19783,1052986,21198067
Brazil,2020-04-19,1091492,20128,1071364,21554415
Brazil,2020-04-20,1106531,20406,1086125,21912680
Brazil,2020-04-21,1125084,20748,1104336,22272826
Brazil,2020-04-22,1144510,21106,1123404,22634817
Brazil,2020-04-23,1160673,21404,1139269,22998618
Brazil,2020-04-24,1178565,21734,1156831,23364192
Brazil,2020-04-25,1197188,22077,1175111,23731504
Brazil,2020-04-26,1220352,22505,1197847,24100517
Brazil,2020-04-27,1237226,22816,1214410,24471193
Brazil,2020-04-28,1253373,23114,1230259,24843496
Brazil,2020-04-29,1275672,23525,1252147,25217390
Brazil,2020-04-30,1291083,23809,1267274,25592835
Brazil,2020-05-01,1307414,24110,1283304,25969796
Brazil,2020-05-02,1332023,24564,1307459,26348234
Brazil,2020-05-03,1353095,24953,1328142,26728111
Brazil,2020-05-04,1369904,25263,1344641,27109389
Brazil,2020-05-05,1383895,25521,1358374,27492030
Brazil,2020-05-06,1407112,25949,1381163,27875995
Brazil,2020-05-07,1425897,26295,1399602,28261246
Brazil,2020-05-08,1446664,26678,1419986,28647743
Brazil,2020-05-09,1463498,26989,1436509,29035448
Brazil,2020-05-10,1484087,27368,1456719,29424321
Brazil,2020-05-11,1501330,27686,1473644,29814323
Brazil,2020-05-12,1524426,28112,1496314,30205415
Brazil,2020-05-13,1540672,28412,1512260,30597556
Brazil,2020-05-14,1564249,28847,1535402,30990706
Brazil,2020-05-15,1581478,29164,1552314,31384826
Brazil,2020-05-16,1596196,29436,1566760,31779875
Brazil,2020-05-17,1624405,29956,1594449,32175813
Brazil,2020-05-18,1643653,30311,1613342,32572600
Brazil,2020-05-19,1665403,30712,1634691,32970194
Brazil,2020-05-20,1678047,30945,1647102,33368555
Brazil,2020-05-21,1701096,31370,1669726,33767641
Brazil,2020-05-22,1722798,31771,1691027,34167412
Brazil,2020-05-23,1743796,32158,1711638,34567827
Brazil,2020-05-24,1759563,32449,1727114,34968843
Brazil,2020-05-25,1783708,32894,1750814,35370420
Brazil,2020-05-26,1801719,33226,1768493,35772516
Brazil,2020-05-27,1819158,33548,1785610,36175088
Brazil,2020-05-28,1841693,33963,1807730,36578096
Brazil,2020-05-29,1864588,34385,1830203,36981496
Brazil,2020-05-30,1879863,34667,1845196,37385247
Brazil,2020-05-31,1905309,35136,1870173,37789307
Brazil,2020-06-01,1924807,35496,1889311,38193633
Brazil,2020-06-02,1943925,35848,1908077,38598182
Brazil,2020-06-03,1961257,36168,1925089,39002913
Brazil,2020-06-04,1981702,36545,1945157,39407781
Brazil,2020-06-05,2004439,36964,1967475,39812746
Brazil,2020-06-06,2023175,37310,1985865,40217762
Brazil,2020-06-07,2045136,37715,2007421,40622789
Brazil,2020-06-08,2068049,38137,2029912,41027782
Brazil,2020-06-09,2085815,38465,2047350,41432698
Brazil,2020-06-10,2106022,38838,2067184,41837495
Brazil,2020-06-11,2126280,39211,2087069,42242128
Brazil,2020-06-12,2149316,39636,2109680,42646555
Brazil,2020-06-13,2170143,40020,2130123,43050731
Brazil,2020-06-14,2188507,40359,2148148,43454614
Brazil,2020-06-15,2208099,40720,2167379,43858160
Brazil,2020-06-16,2228475,41096,2187379,44261324
Brazil,2020-06-17,2251179,41515,2209664,44664064
Brazil,2020-06-18,2269289,41849,2227440,45066336
Brazil,2020-06-19,2291618,42260,2249358,45468095
Brazil,2020-06-20,2307568,42555,2265013,45869298
Brazil,2020-06-21,2325667,42888,2282779,46269901
Brazil,2020-06-22,2347096,43284,2303812,46669860
Brazil,2020-06-23,2367300,43656,2323644,47069130
Brazil,2020-06-24,2391848,44109,2347739,47467668
Brazil,2020-06-25,2409903,44442,2365461,47865430
Brazil,2020-06-26,2426842,44754,2382088,48262371
Brazil,2020-06-27,2449730,45176,2404554,48658447
Brazil,2020-06-28,2467505,45504,2422001,49053614
Brazil,2020-06-29,2490974,45937,2445037,49447829
Brazil,2020-06-30,2506460,46222,2460238,49841045
Brazil,2020-07-01,2523515,46537,2476978,50233221
Brazil,2020-07-02,2545950,46951,2498999,50624310
Brazil,2020-07-03,2565143,47305,2517838,51014269
Brazil,2020-07-04,2582440,47624,2534816,51403054
Brazil,2020-07-05,2605923,48057,2557866,51790620
Brazil,2020-07-06,2627025,48446,2578579,52176923
Brazil,2020-07-07,2640863,48701,2592162,52561918
Brazil,2020-07-08,2664501,49137,2615364,52945562
Brazil,2020-07-09,2680257,49428,2630829,53327811
Brazil,2020-07-10,2700534,49801,2650733,53708619
Brazil,2020-07-11,2719277,50147,2669130,54087943
Brazil,2020-07-12,2738388,50500,2687888,54465738
Brazil,2020-07-13,2758255,50866,2707389,54841961
Brazil,2020-07-14,2773800,51153,2722647,55216567
Brazil,2020-07-15,2797369,51587,2745782,55589512
Brazil,2020-07-16,2814248,51899,2762349,55960752
Brazil,2020-07-17,2833423,52252,2781171,56330243
Brazil,2020-07-18,2848367,52528,2795839,56697941
Brazil,2020-07-19,2865942,52852,2813090,57063801
Brazil,2020-07-20,2889017,53277,2835740,57427781
Brazil,2020-07-21,2902136,53519,2848617,57789836
Brazil,2020-07-22,2922909,53902,2869007,58149923
Brazil,2020-07-23,2942651,54266,2888385,58507997
Brazil,2020-07-24,2958006,54550,2903456,58864015
Brazil,2020-07-25,2978446,54927,2923519,59217933
Brazil,2020-07-26,2992958,55194,2937764,59569708
Brazil,2020-07-27,3008287,55477,2952810,59919296
Brazil,2020-07-28,3029151,55862,2973289,60266654
Brazil,2020-07-29,3046017,56173,2989844,60611739
Brazil,2020-07-30,3068431,56586,3011845,60954507
Brazil,2020-07-31,3077713,56757,3020956,61294915
Brazil,2020-08-01,3096070,57096,3038974,61632920
Brazil,2020-08-02,3111812,57386,3054426,61968479
Brazil,2020-08-03,3129697,57716,3071981,62301549
Brazil,2020-08-04,3146119,58019,3088100,62632087
Brazil,2020-08-05,3161032,58294,3102738,62960051
Brazil,2020-08-06,3180128,58646,3121482,63285398
Brazil,2020-08-07,3194790,58916,3135874,63608085
Brazil,2020-08-08,3214083,59272,3154811,63928071
Brazil,2020-08-09,3225683,59486,3166197,64245312
Brazil,2020-08-10,3246718,59874,3186844,64559767
Brazil,2020-08-11,3258904,60099,3198805,64871394
Brazil,2020-08-12,3276433,60422,3216011,65180150
Brazil,2020-08-13,3289243,60658,3228585,65485995
Brazil,2020-08-14,3302456,60902,3241554,65788885
Brazil,2020-08-15,3318523,61198,3257325,66088781
Brazil,2020-08-16,3330950,61427,3269523,66385640
Brazil,2020-08-17,3348321,61748,3286573,66679421
Brazil,2020-08-18,3363428,62026,3301402,66970083
Brazil,2020-08-19,3377505,62286,3315219,67257585
Brazil,2020-08-20,3394419,62598,3331821,67541886
Brazil,2020-08-21,3405297,62798,3342499,67822946
Brazil,2020-08-22,3415445,62986,3352459,68100725
Brazil,2020-08-23,3440694,63451,3377243,68375181
Brazil,2020-08-24,3445214,63535,3381679,68646275
Brazil,2020-08-25,3462092,63846,3398246,68913966
Brazil,2020-08-26,3470014,63992,3406022,69178215
Brazil,2020-08-27,3486735,64300,3422435,69438982
Brazil,2020-08-28,3497352,64496,3432856,69696228
Brazil,2020-08-29,3505689,64650,3441039,69949913
Brazil,2020-08-30,3523554,64979,3458575,70199998
Brazil,2020-08-31,3536334,65215,3471119,70446444
Brazil,2020-09-01,3548075,65431,3482644,70689213
Brazil,2020-09-02,3560970,65669,3495301,70928266
Brazil,2020-09-03,3571606,65865,3505741,71163564
Brazil,2020-09-04,3583861,66091,3517770,71395069
Brazil,2020-09-05,3595419,66305,3529114,71622744
Brazil,2020-09-06,3606131,66502,3539629,71846550
Brazil,2020-09-07,3616796,66699,3550097,72066449
Brazil,2020-09-08,3626014,66869,3559145,72282406
Brazil,2020-09-09,3639733,67122,3572611,72494381
Brazil,2020-09-10,3648222,67278,3580944,72702340
Brazil,2020-09-11,3658201,67462,3590739,72906243
Brazil,2020-09-12,3670009,67680,3602329,73106056
Brazil,2020-09-13,3679109,67848,3611261,73301742
Brazil,2020-09-14,3686705,67988,3618717,73493264
Brazil,2020-09-15,3700167,68236,3631931,73680588
Brazil,2020-09-16,3704088,68309,3635779,73863677
Brazil,2020-09-17,3713316,68479,3644837,74042496
Brazil,2020-09-18,3725607,68705,3656902,74217009
Brazil,2020-09-19,3736368,68904,3667464,74387183
Brazil,2020-09-20,3739659,68965,3670694,74552982
Brazil,2020-09-21,3749784,69151,3680633,74714372
Brazil,2020-09-22,3754169,69232,3684937,74871319
Brazil,2020-09-23,3762301,69382,3692919,75023789
Brazil,2020-09-24,3774029,69598,3704431,75171748
Brazil,2020-09-25,3779519,69700,3709819,75315162
Brazil,2020-09-26,3788103,69858,3718245,75454000
Brazil,2020-09-27,3794598,69978,3724620,75588227
Brazil,2020-09-28,3794273,69972,3724301,75717812
Brazil,2020-09-29,3802364,70121,3732243,75842722
Brazil,2020-09-30,3811445,70288,3741157,75962925
Brazil,2020-10-01,3812973,70317,3742656,76078389
Brazil,2020-10-02,3819818,70443,3749375,76189082
Brazil,2020-10-03,3830331,70637,3759694,76294974
Brazil,2020-10-04,3831144,70652,3760492,76396034
Brazil,2020-10-05,3838558,70788,3767770,76492230
Brazil,2020-10-06,3841496,70843,3770653,76583533
Brazil,2020-10-07,3844372,70896,3773476,76669913
Brazil,2020-10-08,3846293,70931,3775362,76751339
Brazil,2020-10-09,3854090,71075,3783015,76827782
Brazil,2020-10-10,3860198,71187,3789011,76899213
Brazil,2020-10-11,3858982,71165,3787817,76965604
Brazil,2020-10-12,3863519,71249,3792270,77026925
Brazil,2020-10-13,3862893,71237,3791656,77083148
Brazil,2020-10-14,3867189,71316,3795873,77134246
Brazil,2020-10-15,3871579,71397,3800182,77180190
Brazil,2020-10-16,3874412,71450,3802962,77220953
Brazil,2020-10-17,3875728,71474,3804254,77256509
Brazil,2020-10-18,3871682,71399,3800283,77286831
Brazil,2020-10-19,3876220,71483,3804737,77311892
Brazil,2020-10-20,3876061,71480,3804581,77331666
Brazil,2020-10-21,3878119,71518,3806601,77346127
Brazil,2020-10-22,3878932,71533,3807399,77355251
Brazil,2020-10-23,3881559,71581,3809978,77359011
Brazil,2020-10-24,3879774,71548,3808226,77357384
Brazil,2020-10-25,3881744,71585,3810159,77350345
Brazil,2020-10-26,3876554,71489,3805065,77337869
Brazil,2020-10-27,3874067,71443,3802624,77319934
Brazil,2020-10-28,3878935,71533,3807402,77296515
Brazil,2020-10-29,3875251,71465,3803786,77267589
Brazil,2020-10-30,3870960,71386,3799574,77233135
Brazil,2020-10-31,3871404,71394,3800010,77193129
Brazil,2020-11-01,3869903,71366,3798537,77147550
Brazil,2020-11-02,3865754,71290,3794464,77096376
Brazil,2020-11-03,3861044,71203,3789841,77039585
Brazil,2020-11-04,3858466,71156,3787310,76977158
Brazil,2020-11-05,3856549,71120,3785429,76909072
Brazil,2020-11-06,3852598,71047,3781551,76835308
Brazil,2020-11-07,3850710,71012,3779698,76755847
Brazil,2020-11-08,3843218,70874,3772344,76670668
Brazil,2020-11-09,3837141,70762,3766379,76579753
Brazil,2020-11-10,3839764,70811,3768953,76483082
Brazil,2020-11-11,3829465,70621,3758844,76380638
Brazil,2020-11-12,3825386,70545,3754841,76272402
Brazil,2020-11-13,3818949,70427,3748522,76158357
Brazil,2020-11-14,3812172,70302,3741870,76038486
Brazil,2020-11-15,3804935,70168,3734767,75912771
Brazil,2020-11-16,3792809,69945,3722864,75781197
Brazil,2020-11-17,3789565,69885,3719680,75643747
Brazil,2020-11-18,3785286,69806,3715480,75500405
Brazil,2020-11-19,3771273,69548,3701725,75351156
Brazil,2020-11-20,3769374,69513,3699861,75195985
Brazil,2020-11-21,3762499,69386,3693113,75034878
Brazil,2020-11-22,3754440,69237,3685203,74867820
Brazil,2020-11-23,3745216,69067,3676149,74694798
Brazil,2020-11-24,3736959,68915,3668044,74515798
Brazil,2020-11-25,3729013,68768,3660245,74330808
Brazil,2020-11-26,3718307,68571,3649736,74139814
Brazil,2020-11-27,3706471,68353,3638118,73942805
Brazil,2020-11-28,3695542,68151,3627391,73739768
Brazil,2020-11-29,3685544,67967,3617577,73530693
Brazil,2020-11-30,3673885,67752,3606133,73315568
Brazil,2020-12-01,3665713,67601,3598112,73094384
Brazil,2020-12-02,3653117,67369,3585748,72867128
Brazil,2020-12-03,3639350,67115,3572235,72633793
Brazil,2020-12-04,3630928,66959,3563969,72394368
Brazil,2020-12-05,3615143,66668,3548475,72148845
Brazil,2020-12-06,3601097,66409,3534688,71897216
Brazil,2020-12-07,3590123,66207,3523916,71639471
Brazil,2020-12-08,3575126,65930,3509196,71375604
Brazil,2020-12-09,3565293,65749,3499544,71105606
Brazil,2020-12-10,3547624,65423,3482201,70829472
Brazil,2020-12-11,3534987,65190,3469797,70547195
Brazil,2020-12-12,3522733,64964,3457769,70258769
Brazil,2020-12-13,3504417,64626,3439791,69964188
Brazil,2020-12-14,3491693,64392,3427301,69663447
Brazil,2020-12-15,3473329,64053,3409276,69356541
Brazil,2020-12-16,3460188,63811,3396377,69043466
Brazil,2020-12-17,3444837,63528,3381309,68724219
Brazil,2020-12-18,3427195,63202,3363993,68398795
Brazil,2020-12-19,3410700,62898,3347802,68067192
Brazil,2020-12-20,3394607,62601,3332006,67729406
Brazil,2020-12-21,3375793,62254,3313539,67385437
Brazil,2020-12-22,3360697,61976,3298721,67035281
Brazil,2020-12-23,3343828,61665,3282163,66678939
Brazil,2020-12-24,3320743,61239,3259504,66316408
Brazil,2020-12-25,3307955,61003,3246952,65947689
Brazil,2020-12-26,3284733,60575,3224158,65572781
Brazil,2020-12-27,3270487,60312,3210175,65191685
Brazil,2020-12-28,3246191,59864,3186327,64804402
Brazil,2020-12-29,3228562,59539,3169023,64410933
Brazil,2020-12-30,3208492,59169,3149323,64011280
Brazil,2020-12-31,3185809,58751,3127058,63605445
Brazil,2021-01-01,3166110,58387,3107723,63193430
Brazil,2021-01-02,3148031,58054,3089977,62775239
Brazil,2021-01-03,3122992,57592,3065400,62350874
Brazil,2021-01-04,3101187,57190,3043997,61920341
Brazil,2021-01-05,3077712,56757,3020955,61483644
Brazil,2021-01-06,3061277,56454,3004823,61040786
Brazil,2021-01-07,3034397,55958,2978439,60591775
Brazil,2021-01-08,3015137,55603,2959534,60136614
Brazil,2021-01-09,2988167,55106,2933061,59675311
Brazil,2021-01-10,2968482,54743,2913739,59207871
Brazil,2021-01-11,2943959,54291,2889668,58734303
Brazil,2021-01-12,2917699,53806,2863893,58254613
Brazil,2021-01-13,2892259,53337,2838922,57768809
Brazil,2021-01-14,2867761,52885,2814876,57276901
Brazil,2021-01-15,2842759,52424,2790335,56778895
Brazil,2021-01-16,2821159,52026,2769133,56274803
Brazil,2021-01-17,2793652,51519,2742133,55764633
Brazil,2021-01-18,2765055,50991,2714064,55248396
Brazil,2021-01-19,2740700,50542,2690158,54726102
Brazil,2021-01-20,2714466,50058,2664408,54197763
Brazil,2021-01-21,2683405,49486,2633919,53663389
Brazil,2021-01-22,2660440,49062,2611378,53122994
Brazil,2021-01-23,2635000,48593,2586407,52576588
Brazil,2021-01-24,2605477,48048,2557429,52024186
Brazil,2021-01-25,2578317,47548,2530769,51465799
Brazil,2021-01-26,2550515,47035,2503480,50901443
Brazil,2021-01-27,2520168,46475,2473693,50331131
Brazil,2021-01-28,2493563,45985,2447578,49754878
Brazil,2021-01-29,2465926,45475,2420451,49172699
Brazil,2021-01-30,2430111,44814,2385297,48584609
Brazil,2021-01-31,2402845,44312,2358533,47990625
Brazil,2021-02-01,2378465,43862,2334603,47390762
Brazil,2021-02-02,2343517,43218,2300299,46785038
Brazil,2021-02-03,2312429,42644,2269785,46173470
Brazil,2021-02-04,2281013,42065,2238948,45556076
Brazil,2021-02-05,2253039,41549,2211490,44932874
Brazil,2021-02-06,2216813,40881,2175932,44303882
Brazil,2021-02-07,2188968,40367,2148601,43669120
Brazil,2021-02-08,2154314,39728,2114586,43028607
Brazil,2021-02-09,2120925,39113,2081812,42382363
Brazil,2021-02-10,2089359,38530,2050829,41730408
Brazil,2021-02-11,2056799,37930,2018869,41072764
Brazil,2021-02-12,2022603,37299,1985304,40409452
Brazil,2021-02-13,1992508,36744,1955764,39740493
Brazil,2021-02-14,1954767,36048,1918719,39065910
Brazil,2021-02-15,1922563,35455,1887108,38385725
Brazil,2021-02-16,1889050,34836,1854214,37699961
Brazil,2021-02-17,1853548,34182,1819366,37008642
Brazil,2021-02-18,1820002,33563,1786439,36311791
Brazil,2021-02-19,1782253,32867,1749386,35609434
Brazil,2021-02-20,1749037,32254,1716783,34901594
Brazil,2021-02-21,1713367,31597,1681770,34188298
Brazil,2021-02-22,1678034,30945,1647089,33469571
Brazil,2021-02-23,1635694,30164,1605530,32745438
Brazil,2021-02-24,1604241,29584,1574657,32015927
Brazil,2021-02-25,1568264,28921,1539343,31281064
Brazil,2021-02-26,1528398,28186,1500212,30540877
Brazil,2021-02-27,1490767,27492,1463275,29795394
Brazil,2021-02-28,1452837,26792,1426045,29044643
Brazil,2021-03-01,1414269,26081,1388188,28288653
Brazil,2021-03-02,1379752,25444,1354308,27527452
Brazil,2021-03-03,1344802,24800,1320002,26761071
Brazil,2021-03-04,1300128,23976,1276152,25989539
Brazil,2021-03-05,1261421,23262,1238159,25212887
Brazil,2021-03-06,1223294,22559,1200735,24431145
Brazil,2021-03-07,1180452,21769,1158683,23644345
Brazil,2021-03-08,1142723,21073,1121650,22852519
Brazil,2021-03-09,1104176,20362,1083814,22055698
Brazil,2021-03-10,1062245,19589,1042656,21253916
Brazil,2021-03-11,1026292,18926,1007366,20447204
Brazil,2021-03-12,980353,18079,962274,19635597
Brazil,2021-03-13,944133,17411,926722,18819128
Brazil,2021-03-14,904212,16675,887537,17997831
Brazil,2021-03-15,860536,15869,844667,17171742
Brazil,2021-03-16,817829,15082,802747,16340894
Brazil,2021-03-17,776805,14325,762480,15505323
Brazil,2021-03-18,733272,13522,719750,14665066
Brazil,2021-03-19,687575,12679,674896,13820157
Brazil,2021-03-20,647285,11936,635349,12970635
Brazil,2021-03-21,606579,11186,595393,12116536
Brazil,2021-03-22,561612,10356,551256,11257897
Brazil,2021-03-23,519517,9580,509937,10394756
Brazil,2021-03-24,477975,8814,469161,9527151
Brazil,2021-03-25,433606,7996,425610,8655122
Brazil,2021-03-26,391669,7222,384447,7778706
Brazil,2021-03-27,345949,6379,339570,6897944
Brazil,2021-03-28,301763,5564,296199,6012875
Brazil,2021-03-29,254976,4702,250274,5123540
Brazil,2021-03-30,208926,3852,205074,4229978
Brazil,2021-03-31,165935,3060,162875,3332232
Brazil,2021-04-01,120117,2215,117902,2430342
Brazil,2021-04-02,75954,1400,74554,1524349
Brazil,2021-04-03,28485,525,27960,614297
Brazil,2021-04-04,13215,243,12972,299772
Brazil,2021-04-05,62515,1152,61363,1217817
Brazil,2021-04-06,107887,1989,105898,2139792
Brazil,2021-04-07,153503,2830,150673,3065656
Brazil,2021-04-08,197611,3644,193967,3995364
Brazil,2021-04-09,242987,4481,238506,4928871
Brazil,2021-04-10,289756,5343,284413,5866132
Brazil,2021-04-11,343465,6334,337131,6807104
Brazil,2021-04-12,388816,7170,381646,7751740
Brazil,2021-04-13,436684,8053,428631,8699994
Brazil,2021-04-14,482341,8895,473446,9651821
Brazil,2021-04-15,530288,9779,520509,10607174
Brazil,2021-04-16,580175,10699,569476,11566006
Brazil,2021-04-17,628505,11590,616915,12528270
Brazil,2021-04-18,677549,12495,665054,13493918
Brazil,2021-04-19,729567,13454,716113,14462903
Brazil,2021-04-20,775346,14298,761048,15435176
Brazil,2021-04-21,819567,15114,804453,16410688
Brazil,2021-04-22,867278,15993,851285,17389391
Brazil,2021-04-23,916665,16904,899761,18371236
Brazil,2021-04-24,966890,17830,949060,19356173
Brazil,2021-04-25,1020418,18818,1001600,20344152
Brazil,2021-04-26,1070371,19739,1050632,21335122
Brazil,2021-04-27,1121450,20681,1100769,22329034
Brazil,2021-04-28,1168724,21553,1147171,23325837
Brazil,2021-04-29,1217325,22449,1194876,24325478
Brazil,2021-04-30,1269816,23417,1246399,25327907
Brazil,2021-05-01,1317059,24288,1292771,26333072
Brazil,2021-05-02,1367024,25210,1341814,27340921
Brazil,2021-05-03,1419984,26186,1393798,28351401
Brazil,2021-05-04,1472518,27155,1445363,29364459
Brazil,2021-05-05,1517554,27986,1489568,30380042
Brazil,2021-05-06,1571358,28978,1542380,31398098
Brazil,2021-05-07,1618370,29845,1588525,32418572
Brazil,2021-05-08,1673481,30861,1642620,33441410
Brazil,2021-05-09,1724629,31804,1692825,34466559
Brazil,2021-05-10,1778433,32797,1745636,35493963
Brazil,2021-05-11,1828801,33725,1795076,36523568
Brazil,2021-05-12,1882839,34722,1848117,37555318
Brazil,2021-05-13,1934111,35667,1898444,38589159
Brazil,2021-05-14,1981510,36542,1944968,39625034
Brazil,2021-05-15,2035615,37539,1998076,40662888
Brazil,2021-05-16,2087937,38504,2049433,41702664
Brazil,2021-05-17,2140730,39478,2101252,42744306
Brazil,2021-05-18,2192183,40427,2151756,43787757
Brazil,2021-05-19,2241249,41332,2199917,44832960
Brazil,2021-05-20,2295730,42336,2253394,45879858
Brazil,2021-05-21,2351005,43356,2307649,46928393
Brazil,2021-05-22,2398845,44238,2354607,47978507
Brazil,2021-05-23,2449983,45181,2404802,49030143
Brazil,2021-05-24,2505285,46201,2459084,50083242
Brazil,2021-05-25,2557198,47158,2510040,51137745
Brazil,2021-05-26,2609321,48119,2561202,52193594
Brazil,2021-05-27,2668325,49208,2619117,53250730
Brazil,2021-05-28,2713789,50046,2663743,54309093
Brazil,2021-05-29,2768422,51053,2717369,55368625
Brazil,2021-05-30,2822779,52056,2770723,56429264
Brazil,2021-05-31,2877198,53059,2824139,57490951
Brazil,2021-06-01,2932936,54087,2878849,58553627
Brazil,2021-06-02,2984005,55029,2928976,59617231
Brazil,2021-06-03,3035598,55981,2979617,60681701
Brazil,2021-06-04,3092189,57024,3035165,61746978
Brazil,2021-06-05,3143318,57967,3085351,62813000
Brazil,2021-06-06,3199046,58995,3140051,63879705
Brazil,2021-06-07,3250739,59948,3190791,64947034
Brazil,2021-06-08,3306216,60971,3245245,66014923
Brazil,2021-06-09,3359883,61961,3297922,67083312
Brazil,2021-06-10,3409527,62876,3346651,68152137
Brazil,2021-06-11,3464965,63899,3401066,69221337
Brazil,2021-06-12,3518264,64882,3453382,70290850
Brazil,2021-06-13,3572088,65874,3506214,71360613
Brazil,2021-06-14,3618473,66730,3551743,72430562
Brazil,2021-06-15,3676495,67800,3608695,73500636
Brazil,2021-06-16,3729794,68783,3661011,74570771
Brazil,2021-06-17,3786489,69828,3716661,75640904
Brazil,2021-06-18,3837291,70765,3766526,76710971
Brazil,2021-06-19,3892364,71781,3820583,77780909
Brazil,2021-06-20,3947051,72789,3874262,78850653
Brazil,2021-06-21,3994778,73669,3921109,79920141
Brazil,2021-06-22,4051138,74709,3976429,80989308
Brazil,2021-06-23,4104702,75696,4029006,82058090
Brazil,2021-06-24,4161311,76740,4084571,83126422
Brazil,2021-06-25,4215353,77737,4137616,84194240
Brazil,2021-06-26,4266153,78674,4187479,85261480
Brazil,2021-06-27,4320595,79678,4240917,86328076
Brazil,2021-06-28,4371384,80615,4290769,87393964
Brazil,2021-06-29,4424512,81594,4342918,88459079
Brazil,2021-06-30,4479045,82600,4396445,89523355
Brazil,2021-07-01,4530607,83551,4447056,90586728
Brazil,2021-07-02,4585089,84556,4500533,91649132
Brazil,2021-07-03,4640434,85576,4554858,92710501
Brazil,2021-07-04,4692028,86528,4605500,93770771
Brazil,2021-07-05,4744285,87491,4656794,94829875
Brazil,2021-07-06,4795504,88436,4707068,95887747
Brazil,2021-07-07,4849840,89438,4760402,96944322
Brazil,2021-07-08,4904304,90442,4813862,97999535
Brazil,2021-07-09,4953735,91354,4862381,99053318
Brazil,2021-07-10,5007603,92347,4915256,100105605
Brazil,2021-07-11,5057672,93271,4964401,101156331
Brazil,2021-07-12,5113236,94295,5018941,102205430
Brazil,2021-07-13,5168005,95305,5072700,103252834
Brazil,2021-07-14,5215588,96183,5119405,104298478
Brazil,2021-07-15,5271514,97214,5174300,105342295
Brazil,2021-07-16,5321763,98141,5223622,106384219
Brazil,2021-07-17,5374000,99104,5274896,107424182
Brazil,2021-07-18,5426201,100067,5326134,108462119
Brazil,2021-07-19,5478456,101031,5377425,109497963
Brazil,2021-07-20,5533296,102042,5431254,110531646
Brazil,2021-07-21,5583492,102968,5480524,111563103
Brazil,2021-07-22,5630439,103833,5526606,112592267
Brazil,2021-07-23,5683256,104807,5578449,113619070
Brazil,2021-07-24,5731331,105694,5625637,114643446
Brazil,2021-07-25,5788692,106752,5681940,115665327
Brazil,2021-07-26,5837520,107652,5729868,116684648
Brazil,2021-07-27,5885819,108543,5777276,117701341
Brazil,2021-07-28,5940196,109546,5830650,118715340
Brazil,2021-07-29,5990587,110475,5880112,119726577
Brazil,2021-07-30,6040600,111397,5929203,120734985
Brazil,2021-07-31,6091199,112331,5978868,121740498
Brazil,2021-08-01,6139249,113217,6026032,122743048
Brazil,2021-08-02,6194139,114229,6079910,123742569
Brazil,2021-08-03,6236683,115013,6121670,124738995
Brazil,2021-08-04,6291877,116031,6175846,125732257
Brazil,2021-08-05,6343837,116990,6226847,126722289
Brazil,2021-08-06,6388693,117817,6270876,127709025
Brazil,2021-08-07,6438639,118738,6319901,128692397
Brazil,2021-08-08,6487209,119634,6367575,129672339
Brazil,2021-08-09,6534985,120515,6414470,130648785
Brazil,2021-08-10,6582919,121399,6461520,131621667
Brazil,2021-08-11,6629162,122251,6506911,132590918
Brazil,2021-08-12,6682487,123235,6559252,133556473
Brazil,2021-08-13,6727459,124064,6603395,134518265
Brazil,2021-08-14,6775490,124950,6650540,135476227
Brazil,2021-08-15,6830308,125961,6704347,136430293
Brazil,2021-08-16,6873964,126766,6747198,137380397
Brazil,2021-08-17,6922226,127656,6794570,138326471
Brazil,2021-08-18,6965630,128456,6837174,139268452
Brazil,2021-08-19,7012747,129325,6883422,140206271
Brazil,2021-08-20,7059376,130185,6929191,141139863
Brazil,2021-08-21,7107243,131068,6976175,142069162
Brazil,2021-08-22,7153267,131917,7021350,142994103
Brazil,2021-08-23,7198909,132758,7066151,143914619
Brazil,2021-08-24,7245493,133617,7111876,144830646
Brazil,2021-08-25,7288552,134412,7154140,145742116
Brazil,2021-08-26,7337810,135320,7202490,146648966
Brazil,2021-08-27,7382296,136140,7246156,147551129
Brazil,2021-08-28,7425236,136932,7288304,148448541
Brazil,2021-08-29,7470894,137774,7333120,149341136
Brazil,2021-08-30,7516843,138622,7378221,150228850
Brazil,2021-08-31,7557482,139371,7418111,151111617
Brazil,2021-09-01,7603704,140223,7463481,151989374
Brazil,2021-09-02,7647905,141039,7506866,152862054
Brazil,2021-09-03,7689844,141812,7548032,153729595
Brazil,2021-09-04,7734475,142635,7591840,154591932
Brazil,2021-09-05,7775489,143391,7632098,155449000
Brazil,2021-09-06,7818754,144189,7674565,156300736
Brazil,2021-09-07,7861381,144975,7716406,157147075
Brazil,2021-09-08,7903397,145750,7757647,157987955
Brazil,2021-09-09,7941958,146461,7795497,158823312
Brazil,2021-09-10,7984762,147251,7837511,159653082
Brazil,2021-09-11,8030370,148092,7882278,160477203
Brazil,2021-09-12,8065765,148745,7917020,161295611
Brazil,2021-09-13,8107159,149508,7957651,162108244
Brazil,2021-09-14,8147608,150254,7997354,162915039
Brazil,2021-09-15,8186721,150975,8035746,163715933
Brazil,2021-09-16,8228305,151742,8076563,164510865
Brazil,2021-09-17,8266447,152445,8114002,165299773
Brazil,2021-09-18,8307876,153209,8154667,166082594
Brazil,2021-09-19,8343902,153874,8190028,166859268
Brazil,2021-09-20,8383745,154609,8229136,167629732
Brazil,2021-09-21,8425327,155375,8269952,168393927
Brazil,2021-09-22,8458071,155979,8302092,169151789
Brazil,2021-09-23,8498102,156718,8341384,169903260
Brazil,2021-09-24,8535629,157410,8378219,170648278
Brazil,2021-09-25,8572906,158097,8414809,171386784
Brazil,2021-09-26,8609327,158769,8450558,172118717
Brazil,2021-09-27,8644298,159414,8484884,172844017
Brazil,2021-09-28,8682795,160124,8522671,173562626
Brazil,2021-09-29,8719602,160802,8558800,174274483
Brazil,2021-09-30,8753762,161432,8592330,174979529
Brazil,2021-10-01,8785575,162019,8623556,175677707
Brazil,2021-10-02,8821272,162677,8658595,176368957
Brazil,2021-10-03,8852753,163258,8689495,177053221
Brazil,2021-10-04,8889096,163928,8725168,177730441
Brazil,2021-10-05,8920650,164510,8756140,178400559
Brazil,2021-10-06,8957039,165181,8791858,179063519
Brazil,2021-10-07,8989256,165775,8823481,179719262
Brazil,2021-10-08,9020711,166355,8854356,180367732
Brazil,2021-10-09,9053078,166952,8886126,181008873
Brazil,2021-10-10,9084940,167540,8917400,181642627
Brazil,2021-10-11,9117575,168142,8949433,182268940
Brazil,2021-10-12,9150008,168740,8981268,182887755
Brazil,2021-10-13,9175836,169216,9006620,183499016
Brazil,2021-10-14,9206232,169777,9036455,184102670
Brazil,2021-10-15,9238415,170370,9068045,184698661
Brazil,2021-10-16,9265694,170873,9094821,185286934
Brazil,2021-10-17,9295853,171429,9124424,185867435
Brazil,2021-10-18,9321757,171907,9149850,186440111
Brazil,2021-10-19,9355112,172522,9182590,187004908
Brazil,2021-10-20,9380410,172989,9207421,187561773
Brazil,2021-10-21,9407998,173497,9234501,188110653
Brazil,2021-10-22,9434233,173981,9260252,188651495
Brazil,2021-10-23,9457919,174418,9283501,189184248
Brazil,2021-10-24,9487654,174966,9312688,189708859
Brazil,2021-10-25,9511606,175408,9336198,190225278
Brazil,2021-10-26,9538882,175911,9362971,190733452
Brazil,2021-10-27,9561259,176324,9384935,191233331
Brazil,2021-10-28,9586485,176789,9409696,191724865
Brazil,2021-10-29,9612924,177277,9435647,192208003
Brazil,2021-10-30,9636784,177717,9459067,192682697
Brazil,2021-10-31,9658170,178111,9480059,193148896
Brazil,2021-11-01,9683454,178577,9504877,193606552
Brazil,2021-11-02,9704081,178958,9525123,194055615
Brazil,2021-11-03,9727236,179385,9547851,194496039
Brazil,2021-11-04,9747257,179754,9567503,194927775
Brazil,2021-11-05,9769504,180164,9589340,195350775
Brazil,2021-11-06,9791316,180566,9610750,195764994
Brazil,2021-11-07,9807736,180869,9626867,196170383
Brazil,2021-11-08,9829374,181268,9648106,196566897
Brazil,2021-11-09,9849348,181637,9667711,196954490
Brazil,2021-11-10,9867245,181967,9685278,197333116
Brazil,2021-11-11,9890142,182389,9707753,197702731
Brazil,2021-11-12,9900146,182573,9717573,198063290
Brazil,2021-11-13,9922081,182978,9739103,198414748
Brazil,2021-11-14,9943393,183371,9760022,198757063
Brazil,2021-11-15,9953303,183554,9769749,199090190
Brazil,2021-11-16,9973611,183928,9789683,199414086
Brazil,2021-11-17,9985498,184147,9801351,199728710
Brazil,2021-11-18,10002694,184465,9818229,200034018
Brazil,2021-11-19,10021059,184803,9836256,200329970
Brazil,2021-11-20,10031464,184995,9846469,200616524
Brazil,2021-11-21,10045447,185253,9860194,200893640
Brazil,2021-11-22,10056751,185461,9871290,201161277
Brazil,2021-11-23,10070965,185724,9885241,201419395
Brazil,2021-11-24,10087108,186021,9901087,201667954
Brazil,2021-11-25,10094262,186153,9908109,201906917
Brazil,2021-11-26,10108710,186420,9922290,202136244
Brazil,2021-11-27,10115126,186538,9928588,202355897
Brazil,2021-11-28,10130005,186812,9943193,202565838
Brazil,2021-11-29,10139680,186991,9952689,202766032
Brazil,2021-11-30,10150469,187190,9963279,202956440
Brazil,2021-12-01,10158781,187343,9971438,203137027
Brazil,2021-12-02,10167850,187510,9980340,203307757
Brazil,2021-12-03,10171740,187582,9984158,203468595
Brazil,2021-12-04,10184587,187819,9996768,203619506
Brazil,2021-12-05,10187065,187865,9999200,203760455
Brazil,2021-12-06,10193532,187984,10005548,203891410
Brazil,2021-12-07,10198382,188073,10010309,204012336
Brazil,2021-12-08,10206731,188227,10018504,204123201
Brazil,2021-12-09,10214015,188362,10025653,204223973
Brazil,2021-12-10,10216701,188411,10028290,204314620
Brazil,2021-12-11,10219067,188455,10030612,204395110
Brazil,2021-12-12,10223636,188539,10035097,204465413
Brazil,2021-12-13,10226012,188583,10037429,204525498
Brazil,2021-12-14,10226352,188589,10037763,204575336
Brazil,2021-12-15,10229966,188656,10041310,204614897
Brazil,2021-12-16,10232215,188697,10043518,204644153
Brazil,2021-12-17,10237474,188794,10048680,204663075
Brazil,2021-12-18,10235619,188760,10046859,204671635
Brazil,2021-12-19,10234692,188743,10045949,204669807
Brazil,2021-12-20,10237393,188793,10048600,204657564
Brazil,2021-12-21,10234386,188737,10045649,204634880
Brazil,2021-12-22,10230912,188673,10042239,204601728
Brazil,2021-12-23,10228355,188626,10039729,204558084
Brazil,2021-12-24,10224319,188552,10035767,204503924
Brazil,2021-12-25,10222566,188519,10034047,204439223
Brazil,2021-12-26,10217811,188432,10029379,204363958
Brazil,2021-12-27,10214905,188378,10026527,204278105
Brazil,2021-12-28,10209077,188271,10020806,204181643
Brazil,2021-12-29,10202824,188155,10014669,204074550
Brazil,2021-12-30,10194737,188006,10006731,203956804
Brazil,2021-12-31,10192513,187965,10004548,203828384
India,2020-01-01,11027,337,10690,0
India,2020-01-02,1675,51,1624,12947
India,2020-01-03,3227,98,3129,51790
India,2020-01-04,22372,685,21687,116524
India,2020-01-05,21403,655,20748,207143
India,2020-01-06,10270,314,9956,323638
India,2020-01-07,29600,906,28694,465999
India,2020-01-08,19607,600,19007,634211
India,2020-01-09,58353,1787,56566,828261
India,2020-01-10,57184,1751,55433,1048128
India,2020-01-11,67992,2082,65910,1293793
India,2020-01-12,88038,2696,85342,1565233
India,2020-01-13,104820,3210,101610,1862422
India,2020-01-14,133669,4094,129575,2185332
India,2020-01-15,147812,4527,143285,2533932
India,2020-01-16,157113,4812,152301,2908191
India,2020-01-17,190704,5841,184863,3308072
India,2020-01-18,207866,6366,201500,3733539
India,2020-01-19,219892,6735,213157,4184552
India,2020-01-20,248774,7619,241155,4661067
India,2020-01-21,274435,8405,266030,5163041
India,2020-01-22,310705,9516,301189,5690426
India,2020-01-23,327185,10021,317164,6243172
India,2020-01-24,356641,10923,345718,6821228
India,2020-01-25,420236,12871,407365,7424540
India,2020-01-26,438330,13425,424905,8053049
India,2020-01-27,448413,13734,434679,8706699
India,2020-01-28,501587,15363,486224,9385426
India,2020-01-29,531386,16276,515110,10089167
India,2020-01-30,572445,17533,554912,10817856
India,2020-01-31,607466,18606,588860,11571424
India,2020-02-01,661753,20269,641484,12349801
India,2020-02-02,691105,21168,669937,13152912
India,2020-02-03,727706,22289,705417,13980683
India,2020-02-04,786398,24086,762312,14833036
India,2020-02-05,819909,25113,794796,15709889
India,2020-02-06,864257,26471,837786,16611161
India,2020-02-07,914017,27995,886022,17536766
India,2020-02-08,956704,29303,927401,18486617
India,2020-02-09,1007638,30863,976775,19460625
India,2020-02-10,1050129,32164,1017965,20458697
India,2020-02-11,1099768,33685,1066083,21480739
India,2020-02-12,1149453,35207,1114246,22526656
India,2020-02-13,1198307,36703,1161604,23596347
India,2020-02-14,1260839,38618,1222221,24689712
India,2020-02-15,1327210,40651,1286559,25806648
India,2020-02-16,1388844,42539,1346305,26947049
India,2020-02-17,1442646,44187,1398459,28110807
India,2020-02-18,1474009,45148,1428861,29297811
India,2020-02-19,1589526,48686,1540840,30507950
India,2020-02-20,1645216,50392,1594824,31741110
India,2020-02-21,1699941,52068,1647873,32997172
India,2020-02-22,1784815,54667,1730148,34276018
India,2020-02-23,1810833,55464,1755369,35577527
India,2020-02-24,1917323,58726,1858597,36901575
India,2020-02-25,1946022,59605,1886417,38248036
India,2020-02-26,2031815,62233,1969582,39616784
India,2020-02-27,2081223,63746,2017477,41007687
India,2020-02-28,2170382,66477,2103905,42420614
India,2020-02-29,2247976,68854,2179122,43855430
India,2020-03-01,2314063,70878,2243185,45311998
India,2020-03-02,2400676,73531,2327145,46790181
India,2020-03-03,2467886,75589,2392297,48289837
India,2020-03-04,2536068,77678,2458390,49810823
India,2020-03-05,2613266,80042,2533224,51352995
India,2020-03-06,2711138,83040,2628098,52916205
India,2020-03-07,2770824,84868,2685956,54500305
India,2020-03-08,2873408,88010,2785398,56105142
India,2020-03-09,2959604,90651,2868953,57730564
India,2020-03-10,3002673,91970,2910703,59376415
India,2020-03-11,3125315,95726,3029589,61042538
India,2020-03-12,3223095,98721,3124374,62728774
India,2020-03-13,3284112,100590,3183522,64434960
India,2020-03-14,3375858,103400,3272458,66160934
India,2020-03-15,3469835,106279,3363556,67906530
India,2020-03-16,3540623,108447,3432176,69671580
India,2020-03-17,3636800,111393,3525407,71455916
India,2020-03-18,3706960,113542,3593418,73259365
India,2020-03-19,3818761,116966,3701795,75081755
India,2020-03-20,3916407,119957,3796450,76922910
India,2020-03-21,4010266,122832,3887434,78782652
India,2020-03-22,4112371,125959,3986412,80660804
India,2020-03-23,4182407,128104,4054303,82557183
India,2020-03-24,4282077,131157,4150920,84471607
India,2020-03-25,4412801,135161,4277640,86403891
India,2020-03-26,4482662,137301,4345361,88353848
India,2020-03-27,4586460,140480,4445980,90321290
India,2020-03-28,4682598,143425,4539173,92306027
India,2020-03-29,4772855,146189,4626666,94307866
India,2020-03-30,4908112,150332,4757780,96326613
India,2020-03-31,4980767,152558,4828209,98362073
India,2020-04-01,5075656,155464,4920192,100414049
India,2020-04-02,5188966,158935,5030031,102482340
India,2020-04-03,5272336,161488,5110848,104566746
India,2020-04-04,5396535,165292,5231243,106667064
India,2020-04-05,5498507,168416,5330091,108783089
India,2020-04-06,5627501,172367,5455134,110914616
India,2020-04-07,5717559,175125,5542434,113061436
India,2020-04-08,5847726,179112,5668614,115223340
India,2020-04-09,5964132,182678,5781454,117400116
India,2020-04-10,6065700,185789,5879911,119591551
India,2020-04-11,6162751,188761,5973990,121797432
India,2020-04-12,6279180,192327,6086853,124017542
India,2020-04-13,6368392,195060,6173332,126251663
India,2020-04-14,6500479,199106,6301373,128499575
India,2020-04-15,6604012,202277,6401735,130761058
India,2020-04-16,6739691,206433,6533258,133035890
India,2020-04-17,6880487,210745,6669742,135323846
India,2020-04-18,6967394,213407,6753987,137624701
India,2020-04-19,7049159,215911,6833248,139938227
India,2020-04-20,7188410,220177,6968233,142264197
India,2020-04-21,7312448,223976,7088472,144602380
India,2020-04-22,7429919,227574,7202345,146952544
India,2020-04-23,7537165,230859,7306306,149314458
India,2020-04-24,7669744,234920,7434824,151687885
India,2020-04-25,7768878,237956,7530922,154072592
India,2020-04-26,7893197,241764,7651433,156468340
India,2020-04-27,8035896,246135,7789761,158874891
India,2020-04-28,8134237,249147,7885090,161292005
India,2020-04-29,8277460,253534,8023926,163719440
India,2020-04-30,8373412,256472,8116940,166156956
India,2020-05-01,8539429,261557,8277872,168604306
India,2020-05-02,8627627,264259,8363368,171061247
India,2020-05-03,8758925,268281,8490644,173527532
India,2020-05-04,8890722,272317,8618405,176002914
India,2020-05-05,9002943,275755,8727188,178487142
India,2020-05-06,9137732,279883,8857849,180979968
India,2020-05-07,9269114,283907,8985207,183481140
India,2020-05-08,9400250,287924,9112326,185990406
India,2020-05-09,9524122,291718,9232404,188507511
India,2020-05-10,9637407,295188,9342219,191032201
India,2020-05-11,9764695,299087,9465608,193564220
India,2020-05-12,9926424,304040,9622384,196103311
India,2020-05-13,10034737,307358,9727379,198649216
India,2020-05-14,10136852,310486,9826366,201201676
India,2020-05-15,10279206,314846,9964360,203760430
India,2020-05-16,10401751,318599,10083152,206325217
India,2020-05-17,10533341,322630,10210711,208895775
India,2020-05-18,10647343,326122,10321221,211471841
India,2020-05-19,10787984,330429,10457555,214053150
India,2020-05-20,10948269,335339,10612930,216639437
India,2020-05-21,11061092,338795,10722297,219230436
India,2020-05-22,11148770,341480,10807290,221825880
India,2020-05-23,11330190,347037,10983153,224425500
India,2020-05-24,11458876,350979,11107897,227029028
India,2020-05-25,11569497,354367,11215130,229636195
India,2020-05-26,11715133,358828,11356305,232246729
India,2020-05-27,11824303,362171,11462132,234860360
India,2020-05-28,11960737,366350,11594387,237476814
India,2020-05-29,12119092,371201,11747891,240095820
India,2020-05-30,12225955,374474,11851481,242717103
India,2020-05-31,12335291,377823,11957468,245340389
India,2020-06-01,12491688,382613,12109075,247965402
India,2020-06-02,12623013,386635,12236378,250591868
India,2020-06-03,12772223,391206,12381017,253219508
India,2020-06-04,12887511,394737,12492774,255848047
India,2020-06-05,13013148,398585,12614563,258477205
India,2020-06-06,13165052,403238,12761814,261106705
India,2020-06-07,13283959,406880,12877079,263736268
India,2020-06-08,13403587,410544,12993043,266365613
India,2020-06-09,13561491,415380,13146111,268994461
India,2020-06-10,13679794,419004,13260790,271622530
India,2020-06-11,13808674,422952,13385722,274249540
India,2020-06-12,13942527,427051,13515476,276875209
India,2020-06-13,14056648,430547,13626101,279499253
India,2020-06-14,14195393,434797,13760596,282121392
India,2020-06-15,14333859,439038,13894821,284741340
India,2020-06-16,14462130,442967,14019163,287358816
India,2020-06-17,14613239,447595,14165644,289973534
India,2020-06-18,14729385,451152,14278233,292585211
India,2020-06-19,14868716,455420,14413296,295193562
India,2020-06-20,14987395,459055,14528340,297798301
India,2020-06-21,15131989,463484,14668505,300399144
India,2020-06-22,15252830,467185,14785645,302995804
India,2020-06-23,15377232,470996,14906236,305587996
India,2020-06-24,15506324,474950,15031374,308175434
India,2020-06-25,15622538,478509,15144029,310757831
India,2020-06-26,15771635,483076,15288559,313334900
India,2020-06-27,15892729,486785,15405944,315906356
India,2020-06-28,16014700,490521,15524179,318471910
India,2020-06-29,16164925,495122,15669803,321031276
India,2020-06-30,16260103,498037,15762066,323584167
India,2020-07-01,16398881,502288,15896593,326130295
India,2020-07-02,16545892,506791,16039101,328669373
India,2020-07-03,16662690,510368,16152322,331201114
India,2020-07-04,16783914,514082,16269832,333725230
India,2020-07-05,16913877,518062,16395815,336241433
India,2020-07-06,17038311,521874,16516437,338749436
India,2020-07-07,17139898,524985,16614913,341248952
India,2020-07-08,17280558,529293,16751265,343739693
India,2020-07-09,17431776,533925,16897851,346221372
India,2020-07-10,17523987,536750,16987237,348693702
India,2020-07-11,17651824,540665,17111159,351156395
India,2020-07-12,17771371,544327,17227044,353609165
India,2020-07-13,17899758,548259,17351499,356051725
India,2020-07-14,18014495,551774,17462721,358483787
India,2020-07-15,18150298,555933,17594365,360905067
India,2020-07-16,18266784,559501,17707283,363315277
India,2020-07-17,18394644,563417,17831227,365714131
India,2020-07-18,18488786,566301,17922485,368101344
India,2020-07-19,18617311,570237,18047074,370476631
India,2020-07-20,18736995,573903,18163092,372839706
India,2020-07-21,18863871,577789,18286082,375190284
India,2020-07-22,18963466,580840,18382626,377528081
India,2020-07-23,19103219,585121,18518098,379852814
India,2020-07-24,19222453,588773,18633680,382164198
India,2020-07-25,19307246,591370,18715876,384461949
India,2020-07-26,19428229,595075,18833154,386745787
India,2020-07-27,19541058,598531,18942527,389015427
India,2020-07-28,19697393,603320,19094073,391270588
India,2020-07-29,19767057,605454,19161603,393510989
India,2020-07-30,19907308,609749,19297559,395736349
India,2020-07-31,19977073,611886,19365187,397946387
India,2020-08-01,20090507,615361,19475146,400140824
India,2020-08-02,20203501,618822,19584679,402319381
India,2020-08-03,20309305,622062,19687243,404481779
India,2020-08-04,20424452,625589,19798863,406627741
India,2020-08-05,20524700,628660,19896040,408756988
India,2020-08-06,20628653,631844,19996809,410869246
India,2020-08-07,20760557,635884,20124673,412964236
India,2020-08-08,20865186,639089,20226097,415041685
India,2020-08-09,20964231,642122,20322109,417101318
India,2020-08-10,21060286,645064,20415222,419142862
India,2020-08-11,21155335,647976,20507359,421166043
India,2020-08-12,21247261,650791,20596470,423170589
India,2020-08-13,21340081,653634,20686447,425156229
India,2020-08-14,21456396,657197,20799199,427122693
India,2020-08-15,21532365,659524,20872841,429069712
India,2020-08-16,21631029,662546,20968483,430997015
India,2020-08-17,21755836,666369,21089467,432904336
India,2020-08-18,21860319,669569,21190750,434791409
India,2020-08-19,21932651,671784,21260867,436657966
India,2020-08-20,22034583,674907,21359676,438503743
India,2020-08-21,22106955,677123,21429832,440328476
India,2020-08-22,22181852,679417,21502435,442131902
India,2020-08-23,22297641,682964,21614677,443913760
India,2020-08-24,22384834,685635,21699199,445673787
India,2020-08-25,22464644,688079,21776565,447411726
India,2020-08-26,22545865,690567,21855298,449127316
India,2020-08-27,22646909,693662,21953247,450820301
India,2020-08-28,22703301,695389,22007912,452490424
India,2020-08-29,22788339,697994,22090345,454137429
India,2020-08-30,22866046,700374,22165672,455761063
India,2020-08-31,22960886,703279,22257607,457361072
India,2020-09-01,23023258,705189,22318069,458937205
India,2020-09-02,23106176,707729,22398447,460489212
India,2020-09-03,23182003,710051,22471952,462016842
India,2020-09-04,23263035,712533,22550502,463519849
India,2020-09-05,23319748,714270,22605478,464997986
India,2020-09-06,23413859,717153,22696706,466451006
India,2020-09-07,23500978,719821,22781157,467878667
India,2020-09-08,23555462,721490,22833972,469280726
India,2020-09-09,23643392,724184,22919208,470656941
India,2020-09-10,23707753,726155,22981598,472007072
India,2020-09-11,23765979,727938,23038041,473330881
India,2020-09-12,23820848,729619,23091229,474628130
India,2020-09-13,23883355,731533,23151822,475898586
India,2020-09-14,23955457,733742,23221715,477142012
India,2020-09-15,24000017,735107,23264910,478358176
India,2020-09-16,24038570,736288,23302282,479546848
India,2020-09-17,24129076,739060,23390016,480707798
India,2020-09-18,24163014,740099,23422915,481840798
India,2020-09-19,24220270,741853,23478417,482945620
India,2020-09-20,24287051,743898,23543153,484022041
India,2020-09-21,24337801,745453,23592348,485069837
India,2020-09-22,24370247,746447,23623800,486088786
India,2020-09-23,24441181,748619,23692562,487078668
India,2020-09-24,24499926,750419,23749507,488039266
India,2020-09-25,24517239,750949,23766290,488970361
India,2020-09-26,24595099,753334,23841765,489871739
India,2020-09-27,24599237,753461,23845776,490743187
India,2020-09-28,24691704,756293,23935411,491584494
India,2020-09-29,24697007,756455,23940552,492395448
India,2020-09-30,24743358,757875,23985483,493175843
India,2020-10-01,24752364,758151,23994213,493925472
India,2020-10-02,24813190,760014,24053176,494644131
India,2020-10-03,24851212,761178,24090034,495331616
India,2020-10-04,24879310,762039,24117271,495987727
India,2020-10-05,24903586,762783,24140803,496612265
India,2020-10-06,24927561,763517,24164044,497205034
India,2020-10-07,24983891,765242,24218649,497765837
India,2020-10-08,24994769,765575,24229194,498294481
India,2020-10-09,25040041,766962,24273079,498790776
India,2020-10-10,25034318,766787,24267531,499254531
India,2020-10-11,25056749,767474,24289275,499685559
India,2020-10-12,25093522,768600,24324922,500083675
India,2020-10-13,25077729,768116,24309613,500448694
India,2020-10-14,25099574,768786,24330788,500780437
India,2020-10-15,25145983,770207,24375776,501078722
India,2020-10-16,25127498,769641,24357857,501343373
India,2020-10-17,25129708,769709,24359999,501574213
India,2020-10-18,25190036,771556,24418480,501771071
India,2020-10-19,25152744,770414,24382330,501933774
India,2020-10-20,25180529,771265,24409264,502062153
India,2020-10-21,25183224,771348,24411876,502156042
India,2020-10-22,25146032,770209,24375823,502215275
India,2020-10-23,25181934,771308,24410626,502239689
India,2020-10-24,25190865,771582,24419283,502229125
India,2020-10-25,25186860,771459,24415401,502183423
India,2020-10-26,25189966,771554,24418412,502102427
India,2020-10-27,25165903,770817,24395086,501985984
India,2020-10-28,25173053,771036,24402017,501833941
India,2020-10-29,25143888,770143,24373745,501646148
India,2020-10-30,25122320,769482,24352838,501422460
India,2020-10-31,25110456,769119,24341337,501162729
India,2020-11-01,25092956,768583,24324373,500866815
India,2020-11-02,25110016,769105,24340911,500534575
India,2020-11-03,25056307,767460,24288847,500165873
India,2020-11-04,25060284,767582,24292702,499760572
India,2020-11-05,25030287,766663,24263624,499318538
India,2020-11-06,25008150,765985,24242165,498839640
India,2020-11-07,25002142,765801,24236341,498323750
India,2020-11-08,24949175,764179,24184996,497770742
India,2020-11-09,24933702,763705,24169997,497180490
India,2020-11-10,24893947,762487,24131460,496552874
India,2020-11-11,24857622,761375,24096247,495887773
India,2020-11-12,24855868,761321,24094547,495185072
India,2020-11-13,24766760,758592,24008168,494444656
India,2020-11-14,24765070,758540,24006530,493666412
India,2020-11-15,24715068,757008,23958060,492850232
India,2020-11-16,24656219,755206,23901013,491996009
India,2020-11-17,24640240,754716,23885524,491103637
India,2020-11-18,24545255,751807,23793448,490173015
India,2020-11-19,24514644,750870,23763774,489204043
India,2020-11-20,24454329,749022,23705307,488196625
India,2020-11-21,24423926,748091,23675835,487150665
India,2020-11-22,24348179,745771,23602408,486066072
India,2020-11-23,24312879,744690,23568189,484942757
India,2020-11-24,24245751,742633,23503118,483780632
India,2020-11-25,24181184,740656,23440528,482579614
India,2020-11-26,24130688,739109,23391579,481339621
India,2020-11-27,24057189,736858,23320331,480060573
India,2020-11-28,23979487,734478,23245009,478742394
India,2020-11-29,23964823,734029,23230794,477385011
India,2020-11-30,23849129,730485,23118644,475988351
India,2020-12-01,23752968,727540,23025428,474552348
India,2020-12-02,23697699,725847,22971852,473076934
India,2020-12-03,23615606,723332,22892274,471562046
India,2020-12-04,23566291,721822,22844469,470007624
India,2020-12-05,23479145,719153,22759992,468413609
India,2020-12-06,23398042,716669,22681373,466779947
India,2020-12-07,23303280,713766,22589514,465106585
India,2020-12-08,23218390,711166,22507224,463393473
India,2020-12-09,23128995,708428,22420567,461640564
India,2020-12-10,23042869,705790,22337079,459847813
India,2020-12-11,22963398,703356,22260042,458015178
India,2020-12-12,22862392,700262,22162130,456142622
India,2020-12-13,22768542,697387,22071155,454230106
India,2020-12-14,22670420,694382,21976038,452277598
India,2020-12-15,22575615,691478,21884137,450285067
India,2020-12-16,22465268,688098,21777170,448252485
India,2020-12-17,22362120,684939,21677181,446179826
India,2020-12-18,22267445,682039,21585406,444067069
India,2020-12-19,22133727,677943,21455784,441914194
India,2020-12-20,22020954,674489,21346465,439721182
India,2020-12-21,21904248,670915,21233333,437488022
India,2020-12-22,21808981,667997,21140984,435214700
India,2020-12-23,21664709,663578,21001131,432901209
India,2020-12-24,21578493,660937,20917556,430547543
India,2020-12-25,21450424,657014,20793410,428153699
India,2020-12-26,21345396,653797,20691599,425719677
India,2020-12-27,21196263,649229,20547034,423245479
India,2020-12-28,21076520,645562,20430958,420731112
India,2020-12-29,20966594,642195,20324399,418176584
India,2020-12-30,20839969,638316,20201653,415581905
India,2020-12-31,20679263,633394,20045869,412947091
India,2021-01-01,20556919,629647,19927272,410272158
India,2021-01-02,20422230,625521,19796709,407557126
India,2021-01-03,20285077,621320,19663757,404802017
India,2021-01-04,20136048,616756,19519292,402006857
India,2021-01-05,20015105,613051,19402054,399171675
India,2021-01-06,19827094,607292,19219802,396296502
India,2021-01-07,19701114,603434,19097680,393381372
India,2021-01-08,19564865,599261,18965604,390426322
India,2021-01-09,19414757,594663,18820094,387431392
India,2021-01-10,19274888,590379,18684509,384396625
India,2021-01-11,19118539,585590,18532949,381322066
India,2021-01-12,18941860,580178,18361682,378207764
India,2021-01-13,18805552,576003,18229549,375053770
India,2021-01-14,18617591,570246,18047345,371860140
India,2021-01-15,18478145,565975,17912170,368626929
India,2021-01-16,18326162,561320,17764842,365354199
India,2021-01-17,18151848,555981,17595867,362042012
India,2021-01-18,17968478,550364,17418114,358690434
India,2021-01-19,17792412,544971,17247441,355299534
India,2021-01-20,17603905,539197,17064708,351869384
India,2021-01-21,17455337,534647,16920690,348400059
India,2021-01-22,17259759,528656,16731103,344891635
India,2021-01-23,17086351,523345,16563006,341344194
India,2021-01-24,16901066,517670,16383396,337757818
India,2021-01-25,16729405,512412,16216993,334132594
India,2021-01-26,16551696,506969,16044727,330468612
India,2021-01-27,16370249,501411,15868838,326765962
India,2021-01-28,16170649,495298,15675351,323024741
India,2021-01-29,16004233,490200,15514033,319245045
India,2021-01-30,15795227,483799,15311428,315426977
India,2021-01-31,15593940,477633,15116307,311570638
India,2021-02-01,15412737,472083,14940654,307676137
India,2021-02-02,15239613,466780,14772833,303743581
India,2021-02-03,15018147,459997,14558150,299773085
India,2021-02-04,14807631,453549,14354082,295764762
India,2021-02-05,14588791,446846,14141945,291718731
India,2021-02-06,14402196,441131,13961065,287635113
India,2021-02-07,14201948,434997,13766951,283514032
India,2021-02-08,13984974,428352,13556622,279355615
India,2021-02-09,13757097,421372,13335725,275159990
India,2021-02-10,13556247,415220,13141027,270927292
India,2021-02-11,13374117,409641,12964476,266657655
India,2021-02-12,13158055,403023,12755032,262351217
India,2021-02-13,12908419,395377,12513042,258008119
India,2021-02-14,12710504,389315,12321189,253628506
India,2021-02-15,12463704,381756,12081948,249212525
India,2021-02-16,12276287,376015,11900272,244760324
India,2021-02-17,12035429,368638,11666791,240272057
India,2021-02-18,11818493,361993,11456500,235747879
India,2021-02-19,11553277,353870,11199407,231187948
India,2021-02-20,11356076,347830,11008246,226592426
India,2021-02-21,11114628,340434,10774194,221961476
India,2021-02-22,10892739,333638,10559101,217295265
India,2021-02-23,10658102,326451,10331651,212593962
India,2021-02-24,10409136,318826,10090310,207857740
India,2021-02-25,10160953,311224,9849729,203086774
India,2021-02-26,9939293,304435,9634858,198281242
India,2021-02-27,9685275,296654,9388621,193441325
India,2021-02-28,9429924,288833,9141091,188567206
India,2021-03-01,9183435,281283,8902152,183659072
India,2021-03-02,8928224,273466,8654758,178717111
India,2021-03-03,8692362,266242,8426120,173741516
India,2021-03-04,8463747,259239,8204508,168732482
India,2021-03-05,8198449,251113,7947336,163690205
India,2021-03-06,7934499,243029,7691470,158614886
India,2021-03-07,7697092,235757,7461335,153506728
India,2021-03-08,7417043,227179,7189864,148365937
India,2021-03-09,7170773,219636,6951137,143192720
India,2021-03-10,6906296,211536,6694760,137987288
India,2021-03-11,6657247,203907,6453340,132749857
India,2021-03-12,6360862,194829,6166033,127480641
India,2021-03-13,6105452,187006,5918446,122179861
India,2021-03-14,5827568,178495,5649073,116847737
India,2021-03-15,5578032,170852,5407180,111484496
India,2021-03-16,5328228,163200,5165028,106090363
India,2021-03-17,5032900,154154,4878746,100665568
India,2021-03-18,4759673,145786,4613887,95210345
India,2021-03-19,4504089,137957,4366132,89724928
India,2021-03-20,4230648,129582,4101066,84209554
India,2021-03-21,3937039,120589,3816450,78664465
India,2021-03-22,3668598,112367,3556231,73089903
India,2021-03-23,3363716,103028,3260688,67486114
India,2021-03-24,3115576,95428,3020148,61853345
India,2021-03-25,2842761,87072,2755689,56191848
India,2021-03-26,2535428,77658,2457770,50501876
India,2021-03-27,2213190,67788,2145402,44783685
India,2021-03-28,1946573,59622,1886951,39037532
India,2021-03-29,1673674,51263,1622411,33263679
India,2021-03-30,1368972,41930,1327042,27462389
India,2021-03-31,1100560,33709,1066851,21633928
India,2021-04-01,797992,24442,773550,15778565
India,2021-04-02,485670,14875,470795,9896569
India,2021-04-03,200092,6128,193964,3988216
India,2021-04-04,109760,3361,106399,1946220
India,2021-04-05,398306,12199,386107,7906461
India,2021-04-06,703075,21534,681541,13892226
India,2021-04-07,980104,30020,950084,19903232
India,2021-04-08,1269254,38876,1230378,25939193
India,2021-04-09,1621576,49667,1571909,31999822
India,2021-04-10,1932952,59205,1873747,38084829
India,2021-04-11,2215583,67862,2147721,44193920
India,2021-04-12,2540128,77802,2462326,50326802
India,2021-04-13,2826683,86579,2740104,56483176
India,2021-04-14,3126289,95756,3030533,62662744
India,2021-04-15,3426450,104950,3321500,68865203
India,2021-04-16,3755862,115039,3640823,75090249
India,2021-04-17,4073990,124784,3949206,81337577
India,2021-04-18,4412405,135149,4277256,87606877
India,2021-04-19,4699601,143946,4555655,93897838
India,2021-04-20,5014903,153603,4861300,100210147
India,2021-04-21,5324042,163072,5160970,106543490
India,2021-04-22,5660642,173382,5487260,112897548
India,2021-04-23,5975891,183038,5792853,119272001
India,2021-04-24,6310308,193281,6117027,125666529
India,2021-04-25,6642539,203457,6439082,132080807
India,2021-04-26,6948193,212819,6735374,138514508
India,2021-04-27,7277494,222905,7054589,144967305
India,2021-04-28,7575041,232019,7343022,151438868
India,2021-04-29,7911620,242328,7669292,157928863
India,2021-04-30,8237582,252312,7985270,164436956
India,2021-05-01,8570308,262503,8307805,170962812
India,2021-05-02,8928771,273483,8655288,177506090
India,2021-05-03,9191635,281534,8910101,184066451
India,2021-05-04,9555377,292675,9262702,190643553
India,2021-05-05,9877204,302533,9574671,197237050
India,2021-05-06,10222329,313104,9909225,203846596
India,2021-05-07,10520360,322232,10198128,210471842
India,2021-05-08,10864079,332760,10531319,217112439
India,2021-05-09,11210495,343371,10867124,223768035
India,2021-05-10,11538266,353410,11184856,230438273
India,2021-05-11,11844167,362780,11481387,237122800
India,2021-05-12,12203500,373786,11829714,243821257
India,2021-05-13,12540843,384119,12156724,250533285
India,2021-05-14,12887826,394746,12493080,257258521
India,2021-05-15,13238119,405476,12832643,263996602
India,2021-05-16,13551942,415088,13136854,270747164
India,2021-05-17,13883604,425247,13458357,277509840
India,2021-05-18,14211868,435301,13776567,284284261
India,2021-05-19,14597584,447115,14150469,291070057
India,2021-05-20,14922140,457056,14465084,297866856
India,2021-05-21,15255216,467258,14787958,304674284
India,2021-05-22,15588347,477462,15110885,311491967
India,2021-05-23,15931888,487984,15443904,318319526
India,2021-05-24,16273626,498452,15775174,325156584
India,2021-05-25,16608828,508719,16100109,332002761
India,2021-05-26,16969871,519777,16450094,338857674
India,2021-05-27,17287876,529518,16758358,345720941
India,2021-05-28,17638541,540258,17098283,352592177
India,2021-05-29,17993069,551117,17441952,359470995
India,2021-05-30,18311052,560857,17750195,366357009
India,2021-05-31,18656492,571438,18085054,373249827
India,2021-06-01,19010240,582273,18427967,380149061
India,2021-06-02,19410212,594524,18815688,387054318
India,2021-06-03,19692487,603169,19089318,393965204
India,2021-06-04,20049287,614098,19435189,400881324
India,2021-06-05,20378784,624190,19754594,407802282
India,2021-06-06,20735832,635127,20100705,414727682
India,2021-06-07,21077763,645600,20432163,421657122
India,2021-06-08,21434233,656518,20777715,428590205
India,2021-06-09,21774720,666947,21107773,435526528
India,2021-06-10,22112925,677306,21435619,442465688
India,2021-06-11,22484686,688693,21795993,449407281
India,2021-06-12,22856700,700088,22156612,456350904
India,2021-06-13,23186653,710194,22476459,463296148
India,2021-06-14,23524494,720542,22803952,470242607
India,2021-06-15,23876343,731319,23145024,477189872
India,2021-06-16,24242097,742522,23499575,484137533
India,2021-06-17,24594918,753328,23841590,491085180
India,2021-06-18,24930127,763596,24166531,498032401
India,2021-06-19,25256198,773583,24482615,504978782
India,2021-06-20,25592915,783896,24809019,511923911
India,2021-06-21,25949368,794814,25154554,518867371
India,2021-06-22,26294609,805389,25489220,525808748
India,2021-06-23,26657374,816500,25840874,532747624
India,2021-06-24,27027208,827828,26199380,539683581
India,2021-06-25,27356188,837904,26518284,546616202
India,2021-06-26,27700024,848436,26851588,553545066
India,2021-06-27,28049648,859145,27190503,560469753
India,2021-06-28,28388137,869512,27518625,567389842
India,2021-06-29,28728648,879942,27848706,574304911
India,2021-06-30,29068541,890353,28178188,581214537
India,2021-07-01,29429428,901407,28528021,588118297
India,2021-07-02,29796821,912660,28884161,595015766
India,2021-07-03,30121833,922615,29199218,601906519
India,2021-07-04,30458827,932937,29525890,608790131
India,2021-07-05,30786434,942971,29843463,615666176
India,2021-07-06,31154621,954248,30200373,622534226
India,2021-07-07,31482764,964299,30518465,629393854
India,2021-07-08,31828441,974887,30853554,636244632
India,2021-07-09,32173978,985471,31188507,643086132
India,2021-07-10,32503393,995560,31507833,649917923
India,2021-07-11,32866496,1006682,31859814,656739577
India,2021-07-12,33205924,1017079,32188845,663550663
India,2021-07-13,33538208,1027256,32510952,670350750
India,2021-07-14,33886360,1037920,32848440,677139408
India,2021-07-15,34209402,1047815,33161587,683916205
India,2021-07-16,34564524,1058692,33505832,690680709
India,2021-07-17,34889189,1068636,33820553,697432489
India,2021-07-18,35230663,1079095,34151568,704171110
India,2021-07-19,35562601,1089262,34473339,710896142
India,2021-07-20,35907494,1099826,34807668,717607150
India,2021-07-21,36240686,1110032,35130654,724303701
India,2021-07-22,36568791,1120081,35448710,730985362
India,2021-07-23,36900668,1130247,35770421,737651699
India,2021-07-24,37236064,1140520,36095544,744302278
India,2021-07-25,37544209,1149958,36394251,750936665
India,2021-07-26,37912318,1161233,36751085,757554425
India,2021-07-27,38229579,1170950,37058629,764155125
India,2021-07-28,38579579,1181671,37397908,770738330
India,2021-07-29,38880998,1190903,37690095,777303606
India,2021-07-30,39228873,1201558,38027315,783850518
India,2021-07-31,39543730,1211202,38332528,790378632
India,2021-08-01,39870466,1221210,38649256,796887514
India,2021-08-02,40185911,1230872,38955039,803376729
India,2021-08-03,40520864,1241131,39279733,809845842
India,2021-08-04,40843870,1251025,39592845,816294421
India,2021-08-05,41137208,1260009,39877199,822722031
India,2021-08-06,41473390,1270307,40203083,829128238
India,2021-08-07,41804260,1280441,40523819,835512609
India,2021-08-08,42118064,1290053,40828011,841874710
India,2021-08-09,42408842,1298959,41109883,848214109
India,2021-08-10,42750581,1309426,41441155,854530372
India,2021-08-11,43071453,1319254,41752199,860823067
India,2021-08-12,43384798,1328852,42055946,867091761
India,2021-08-13,43695102,1338356,42356746,873336024
India,2021-08-14,44006661,1347899,42658762,879555423
India,2021-08-15,44325783,1357674,42968109,885749527
India,2021-08-16,44632015,1367053,43264962,891917907
India,2021-08-17,44935012,1376334,43558678,898060131
India,2021-08-18,45221139,1385098,43836041,904175770
India,2021-08-19,45538946,1394832,44144114,910264395
India,2021-08-20,45839551,1404040,44435511,916325577
India,2021-08-21,46120776,1412653,44708123,922358889
India,2021-08-22,46420627,1421838,44998789,928363903
India,2021-08-23,46741147,1431655,45309492,934340192
India,2021-08-24,47043255,1440908,45602347,940287330
India,2021-08-25,47342292,1450068,45892224,946204892
India,2021-08-26,47615114,1458424,46156690,952092453
India,2021-08-27,47920288,1467771,46452517,957949589
India,2021-08-28,48214040,1476769,46737271,963775876
India,2021-08-29,48509612,1485822,47023790,969570892
India,2021-08-30,48797096,1494628,47302468,975334216
India,2021-08-31,49068540,1502942,47565598,981065427
India,2021-09-01,49375963,1512358,47863605,986764104
India,2021-09-02,49627285,1520056,48107229,992429829
India,2021-09-03,49929914,1529325,48400589,998062184
India,2021-09-04,50204454,1537734,48666720,1003660751
India,2021-09-05,50498968,1546755,48952213,1009225114
India,2021-09-06,50757084,1554661,49202423,1014754858
India,2021-09-07,51036087,1563207,49472880,1020249569
India,2021-09-08,51305115,1571447,49733668,1025708833
India,2021-09-09,51555186,1579106,49976080,1031132239
India,2021-09-10,51842301,1587901,50254400,1036519376
India,2021-09-11,52123140,1596502,50526638,1041869833
India,2021-09-12,52387555,1604601,50782954,1047183203
India,2021-09-13,52633214,1612126,51021088,1052459077
India,2021-09-14,52885295,1619847,51265448,1057697050
India,2021-09-15,53159200,1628236,51530964,1062896717
India,2021-09-16,53411522,1635965,51775557,1068057673
India,2021-09-17,53668590,1643839,52024751,1073179516
India,2021-09-18,53911422,1651277,52260145,1078261845
India,2021-09-19,54209913,1660419,52549494,1083304261
India,2021-09-20,54423786,1666970,52756816,1088306365
India,2021-09-21,54667367,1674431,52992936,1093267759
India,2021-09-22,54945308,1682944,53262364,1098188049
India,2021-09-23,55182870,1690220,53492650,1103066841
India,2021-09-24,55424107,1697609,53726498,1107903740
India,2021-09-25,55662026,1704897,53957129,1112698357
India,2021-09-26,55896083,1712066,54184017,1117450302
India,2021-09-27,56121399,1718967,54402432,1122159186
India,2021-09-28,56345939,1725844,54620095,1126824624
India,2021-09-29,56573908,1732827,54841081,1131446229
India,2021-09-30,56829124,1740644,55088480,1136023620
India,2021-10-01,57055720,1747585,55308135,1140556414
India,2021-10-02,57250155,1753540,55496615,1145044232
India,2021-10-03,57481369,1760622,55720747,1149486694
India,2021-10-04,57708844,1767590,55941254,1153883426
India,2021-10-05,57920841,1774083,56146758,1158234052
India,2021-10-06,58142845,1780883,56361962,1162538199
India,2021-10-07,58347911,1787164,56560747,1166795496
India,2021-10-08,58570143,1793971,56776172,1171005574
India,2021-10-09,58769769,1800085,56969684,1175168065
India,2021-10-10,58999898,1807134,57192764,1179282604
India,2021-10-11,59191701,1813009,57378692,1183348827
India,2021-10-12,59392275,1819152,57573123,1187366373
India,2021-10-13,59586367,1825097,57761270,1191334881
India,2021-10-14,59789784,1831328,57958456,1195253995
India,2021-10-15,59977670,1837082,58140588,1199123359
India,2021-10-16,60182009,1843341,58338668,1202942618
India,2021-10-17,60341816,1848236,58493580,1206711421
India,2021-10-18,60536263,1854192,58682071,1210429418
India,2021-10-19,60741835,1860488,58881347,1214096263
India,2021-10-20,60910425,1865652,59044773,1217711610
India,2021-10-21,61072268,1870609,59201659,1221275116
India,2021-10-22,61259805,1876353,59383452,1224786440
India,2021-10-23,61434701,1881710,59552991,1228245243
India,2021-10-24,61596240,1886658,59709582,1231651188
India,2021-10-25,61757935,1891611,59866324,1235003942
India,2021-10-26,61947288,1897411,60049877,1238303172
India,2021-10-27,62081971,1901536,60180435,1241548549
India,2021-10-28,62259992,1906989,60353003,1244739746
India,2021-10-29,62405855,1911456,60494399,1247876437
India,2021-10-30,62560014,1916178,60643836,1250958300
India,2021-10-31,62717958,1921016,60796942,1253985015
India,2021-11-01,62873196,1925771,60947425,1256956264
India,2021-11-02,63008606,1929918,61078688,1259871731
India,2021-11-03,63125024,1933484,61191540,1262731104
India,2021-11-04,63306213,1939034,61367179,1265534073
India,2021-11-05,63401200,1941943,61459257,1268280329
India,2021-11-06,63562418,1946881,61615537,1270969567
India,2021-11-07,63689759,1950782,61738977,1273601485
India,2021-11-08,63833776,1955193,61878583,1276175781
India,2021-11-09,63955058,1958908,61996150,1278692160
India,2021-11-10,64074079,1962553,62111526,1281150325
India,2021-11-11,64201367,1966452,62234915,1283549984
India,2021-11-12,64306677,1969677,62337000,1285890848
India,2021-11-13,64423314,1973250,62450064,1288172630
India,2021-11-14,64503091,1975694,62527397,1290395046
India,2021-11-15,64652673,1980275,62672398,1292557813
India,2021-11-16,64740120,1982954,62757166,1294660654
India,2021-11-17,64840061,1986015,62854046,1296703292
India,2021-11-18,64957171,1989602,62967569,1298685454
India,2021-11-19,65028805,1991796,63037009,1300606870
India,2021-11-20,65136611,1995098,63141513,1302467272
India,2021-11-21,65255275,1998733,63256542,1304266396
India,2021-11-22,65298464,2000055,63298409,1306003979
India,2021-11-23,65406582,2003367,63403215,1307679764
India,2021-11-24,65486124,2005803,63480321,1309293494
India,2021-11-25,65539552,2007440,63532112,1310844915
India,2021-11-26,65628088,2010152,63617936,1312333779
India,2021-11-27,65681744,2011795,63669949,1313759838
India,2021-11-28,65745668,2013753,63731915,1315122848
India,2021-11-29,65836063,2016522,63819541,1316422568
India,2021-11-30,65877834,2017801,63860033,1317658760
India,2021-12-01,65957636,2020245,63937391,1318831189
India,2021-12-02,65971624,2020674,63950950,1319939623
India,2021-12-03,66064023,2023504,64040519,1320983834
India,2021-12-04,66089096,2024272,64064824,1321963596
India,2021-12-05,66137175,2025745,64111430,1322878686
India,2021-12-06,66186776,2027264,64159512,1323728885
India,2021-12-07,66239455,2028877,64210578,1324513978
India,2021-12-08,66268088,2029754,64238334,1325233750
India,2021-12-09,66328239,2031597,64296642,1325887994
India,2021-12-10,66324656,2031487,64293169,1326476501
India,2021-12-11,66348866,2032229,64316637,1326999068
India,2021-12-12,66374479,2033013,64341466,1327455497
India,2021-12-13,66436668,2034918,64401750,1327845589
India,2021-12-14,66429090,2034686,64394404,1328169153
India,2021-12-15,66434600,2034855,64399745,1328425997
India,2021-12-16,66429559,2034700,64394859,1328615934
India,2021-12-17,66435544,2034884,64400660,1328738783
India,2021-12-18,66444476,2035157,64409319,1328794362
India,2021-12-19,66432579,2034793,64397786,1328782495
India,2021-12-20,66451345,2035367,64415978,1328703008
India,2021-12-21,66421210,2034444,64386766,1328555733
India,2021-12-22,66412131,2034166,64377965,1328340502
India,2021-12-23,66399118,2033768,64365350,1328057152
India,2021-12-24,66389073,2033460,64355613,1327705525
India,2021-12-25,66340108,2031960,64308148,1327285465
India,2021-12-26,66333949,2031772,64302177,1326796818
India,2021-12-27,66326065,2031530,64294535,1326239436
India,2021-12-28,66277779,2030051,64247728,1325613174
India,2021-12-29,66235874,2028768,64207106,1324917889
India,2021-12-30,66215969,2028158,64187811,1324153444
India,2021-12-31,66150953,2026167,64124786,1323319703
Russia,2020-01-01,421,9,412,0
Russia,2020-01-02,262,5,257,1369
Russia,2020-01-03,763,16,747,5476
Russia,2020-01-04,1586,34,1552,12322
Russia,2020-01-05,2008,44,1964,21905
Russia,2020-01-06,256,5,251,34224
Russia,2020-01-07,506,11,495,49279
Russia,2020-01-08,2562,56,2506,67067
Russia,2020-01-09,4944,108,4836,87588
Russia,2020-01-10,7831,171,7660,110838
Russia,2020-01-11,8167,179,7988,136817
Russia,2020-01-12,10137,222,9915,165522
Russia,2020-01-13,9717,213,9504,196949
Russia,2020-01-14,12726,279,12447,231097
Russia,2020-01-15,14864,326,14538,267961
Russia,2020-01-16,15740,345,15395,307539
Russia,2020-01-17,17491,384,17107,349826
Russia,2020-01-18,21066,462,20604,394819
Russia,2020-01-19,24841,545,24296,442513
Russia,2020-01-20,25169,552,24617,492904
Russia,2020-01-21,28933,635,28298,545987
Russia,2020-01-22,34096,748,33348,601758
Russia,2020-01-23,34377,755,33622,660210
Russia,2020-01-24,38294,841,37453,721339
Russia,2020-01-25,41412,909,40503,785139
Russia,2020-01-26,44707,981,43726,851604
Russia,2020-01-27,50964,1119,49845,920727
Russia,2020-01-28,52655,1156,51499,992502
Russia,2020-01-29,53729,1180,52549,1066922
Russia,2020-01-30,62194,1365,60829,1143980
Russia,2020-01-31,64439,1415,63024,1223669
Russia,2020-02-01,67698,1486,66212,1305982
Russia,2020-02-02,74548,1637,72911,1390910
Russia,2020-02-03,75908,1667,74241,1478447
Russia,2020-02-04,84143,1848,82295,1568582
Russia,2020-02-05,86500,1899,84601,1661309
Russia,2020-02-06,92684,2035,90649,1756618
Russia,2020-02-07,100674,2211,98463,1854500
Russia,2020-02-08,101570,2230,99340,1954946
Russia,2020-02-09,106402,2336,104066,2057946
Russia,2020-02-10,110349,2423,107926,2163492
Russia,2020-02-11,117220,2574,114646,2271572
Russia,2020-02-12,121498,2668,118830,2382177
Russia,2020-02-13,128478,2821,125657,2495296
Russia,2020-02-14,138840,3049,135791,2610919
Russia,2020-02-15,140780,3091,137689,2729034
Russia,2020-02-16,145910,3204,142706,2849630
Russia,2020-02-17,152648,3352,149296,2972697
Russia,2020-02-18,158712,3485,155227,3098222
Russia,2020-02-19,167323,3674,163649,3226193
Russia,2020-02-20,172263,3783,168480,3356599
Russia,2020-02-21,181464,3985,177479,3489427
Russia,2020-02-22,185497,4074,181423,3624664
Russia,2020-02-23,192553,4229,188324,3762297
Russia,2020-02-24,198692,4363,194329,3902314
Russia,2020-02-25,206639,4538,202101,4044702
Russia,2020-02-26,211984,4655,207329,4189446
Russia,2020-02-27,218838,4806,214032,4336533
Russia,2020-02-28,230406,5060,225346,4485949
Russia,2020-02-29,234611,5152,229459,4637679
Russia,2020-03-01,245528,5392,240136,4791710
Russia,2020-03-02,252097,5536,246561,4948027
Russia,2020-03-03,262203,5758,256445,5106615
Russia,2020-03-04,266434,5851,260583,5267458
Russia,2020-03-05,278051,6106,271945,5430542
Russia,2020-03-06,286001,6281,279720,5595850
Russia,2020-03-07,294495,6468,288027,5763367
Russia,2020-03-08,304165,6680,297485,5933078
Russia,2020-03-09,311294,6837,304457,6104965
Russia,2020-03-10,316393,6949,309444,6279012
Russia,2020-03-11,329501,7236,322265,6455204
Russia,2020-03-12,338299,7430,330869,6633522
Russia,2020-03-13,346567,7611,338956,6813950
Russia,2020-03-14,354891,7794,347097,6996470
Russia,2020-03-15,364892,8014,356878,7181066
Russia,2020-03-16,376948,8278,368670,7367719
Russia,2020-03-17,382980,8411,374569,7556411
Russia,2020-03-18,391386,8596,382790,7747124
Russia,2020-03-19,401486,8817,392669,7939841
Russia,2020-03-20,413378,9079,404299,8134541
Russia,2020-03-21,425767,9351,416416,8331208
Russia,2020-03-22,436543,9587,426956,8529821
Russia,2020-03-23,444366,9759,434607,8730362
Russia,2020-03-24,452171,9931,442240,8932811
Russia,2020-03-25,462607,10160,452447,9137148
Russia,2020-03-26,475535,10444,465091,9343355
Russia,2020-03-27,486666,10688,475978,9551410
Russia,2020-03-28,494342,10857,483485,9761295
Russia,2020-03-29,508003,11157,496846,9972988
Russia,2020-03-30,516325,11340,504985,10186469
Russia,2020-03-31,528525,11608,516917,10401717
Russia,2020-04-01,540063,11861,528202,10618712
Russia,2020-04-02,547224,12018,535206,10837433
Russia,2020-04-03,561125,12324,548801,11057857
Russia,2020-04-04,573715,12600,561115,11279964
Russia,2020-04-05,582057,12783,569274,11503732
Russia,2020-04-06,592661,13016,579645,11729140
Russia,2020-04-07,606332,13316,593016,11956164
Russia,2020-04-08,617291,13557,603734,12184784
Russia,2020-04-09,628184,13796,614388,12414977
Russia,2020-04-10,640300,14063,626237,12646719
Russia,2020-04-11,649583,14266,635317,12879990
Russia,2020-04-12,664403,14592,649811,13114765
Russia,2020-04-13,678002,14891,663111,13351021
Russia,2020-04-14,686573,15079,671494,13588736
Russia,2020-04-15,698416,15339,683077,13827887
Russia,2020-04-16,711956,15636,696320,14068448
Russia,2020-04-17,728005,15989,712016,14310398
Russia,2020-04-18,737672,16201,721471,14553712
Russia,2020-04-19,748211,16433,731778,14798366
Russia,2020-04-20,760754,16708,744046,15044335
Russia,2020-04-21,774856,17018,757838,15291596
Russia,2020-04-22,784253,17224,767029,15540124
Russia,2020-04-23,799009,17548,781461,15789895
Russia,2020-04-24,809081,17770,791311,16040883
Russia,2020-04-25,824716,18113,806603,16293064
Russia,2020-04-26,835649,18353,817296,16546413
Russia,2020-04-27,849140,18649,830491,16800904
Russia,2020-04-28,861148,18913,842235,17056512
Russia,2020-04-29,875569,19230,856339,17313212
Russia,2020-04-30,887225,19486,867739,17570977
Russia,2020-05-01,903612,19846,883766,17829783
Russia,2020-05-02,915565,20108,895457,18089602
Russia,2020-05-03,924672,20308,904364,18350410
Russia,2020-05-04,939984,20645,919339,18612180
Russia,2020-05-05,953952,20951,933001,18874885
Russia,2020-05-06,965430,21203,944227,19138500
Russia,2020-05-07,981131,21548,959583,19402997
Russia,2020-05-08,994265,21837,972428,19668350
Russia,2020-05-09,1005892,22092,983800,19934532
Russia,2020-05-10,1020831,22420,998411,20201516
Russia,2020-05-11,1029305,22606,1006699,20469275
Russia,2020-05-12,1048265,23023,1025242,20737782
Russia,2020-05-13,1061073,23304,1037769,21007010
Russia,2020-05-14,1071722,23538,1048184,21276931
Russia,2020-05-15,1087240,23879,1063361,21547517
Russia,2020-05-16,1097509,24104,1073405,21818742
Russia,2020-05-17,1112976,24444,1088532,22090576
Russia,2020-05-18,1129342,24803,1104539,22362993
Russia,2020-05-19,1141403,25068,1116335,22635965
Russia,2020-05-20,1155028,25368,1129660,22909463
Russia,2020-05-21,1168923,25673,1143250,23183459
Russia,2020-05-22,1182505,25971,1156534,23457925
Russia,2020-05-23,1197824,26308,1171516,23732833
Russia,2020-05-24,1209274,26559,1182715,24008155
Russia,2020-05-25,1224602,26896,1197706,24283860
Russia,2020-05-26,1236149,27149,1209000,24559923
Russia,2020-05-27,1252747,27514,1225233,24836312
Russia,2020-05-28,1265056,27784,1237272,25113000
Russia,2020-05-29,1279338,28098,1251240,25389958
Russia,2020-05-30,1292753,28393,1264360,25667157
Russia,2020-05-31,1306832,28702,1278130,25944568
Russia,2020-06-01,1319613,28982,1290631,26222161
Russia,2020-06-02,1335469,29331,1306138,26499908
Russia,2020-06-03,1349713,29644,1320069,26777779
Russia,2020-06-04,1360882,29889,1330993,27055745
Russia,2020-06-05,1375875,30218,1345657,27333776
Russia,2020-06-06,1390713,30544,1360169,27611844
Russia,2020-06-07,1403719,30830,1372889,27889918
Russia,2020-06-08,1418189,31147,1387042,28167970
Russia,2020-06-09,1434790,31512,1403278,28445969
Russia,2020-06-10,1444859,31733,1413126,28723885
Russia,2020-06-11,1456878,31997,1424881,29001689
Russia,2020-06-12,1473278,32357,1440921,29279352
Russia,2020-06-13,1487563,32671,1454892,29556843
Russia,2020-06-14,1501207,32971,1468236,29834132
Russia,2020-06-15,1516182,33300,1482882,30111190
Russia,2020-06-16,1528143,33562,1494581,30387986
Russia,2020-06-17,1541767,33862,1507905,30664490
Russia,2020-06-18,1556320,34181,1522139,30940673
Russia,2020-06-19,1570154,34485,1535669,31216504
Russia,2020-06-20,1587987,34877,1553110,31491954
Russia,2020-06-21,1600920,35161,1565759,31766991
Russia,2020-06-22,1609959,35359,1574600,32041586
Russia,2020-06-23,1623295,35652,1587643,32315708
Russia,2020-06-24,1639676,36012,1603664,32589328
Russia,2020-06-25,1656254,36376,1619878,32862415
Russia,2020-06-26,1668071,36636,1631435,33134938
Russia,2020-06-27,1680655,36912,1643743,33406867
Russia,2020-06-28,1693609,37197,1656412,33678173
Russia,2020-06-29,1709386,37543,1671843,33948824
Russia,2020-06-30,1721578,37811,1683767,34218790
Russia,2020-07-01,1737313,38156,1699157,34488042
Russia,2020-07-02,1745753,38342,1707411,34756547
Russia,2020-07-03,1762225,38704,1723521,35024277
Russia,2020-07-04,1774134,38965,1735169,35291200
Russia,2020-07-05,1788868,39289,1749579,35557287
Russia,2020-07-06,1801893,39575,1762318,35822507
Russia,2020-07-07,1815488,39873,1775615,36086829
Russia,2020-07-08,1829342,40178,1789164,36350223
Russia,2020-07-09,1843066,40479,1802587,36612658
Russia,2020-07-10,1856959,40784,1816175,36874105
Russia,2020-07-11,1867155,41008,1826147,37134533
Russia,2020-07-12,1879308,41275,1838033,37393912
Russia,2020-07-13,1891224,41537,1849687,37652211
Russia,2020-07-14,1906505,41872,1864633,37909400
Russia,2020-07-15,1919889,42166,1877723,38165448
Russia,2020-07-16,1929443,42376,1887067,38420326
Russia,2020-07-17,1945761,42735,1903026,38674003
Russia,2020-07-18,1956561,42972,1913589,38926450
Russia,2020-07-19,1967431,43211,1924220,39177634
Russia,2020-07-20,1980515,43498,1937017,39427528
Russia,2020-07-21,1992799,43768,1949031,39676100
Russia,2020-07-22,2005179,44040,1961139,39923320
Russia,2020-07-23,2019646,44357,1975289,40169159
Russia,2020-07-24,2032289,44635,1987654,40413586
Russia,2020-07-25,2045650,44929,2000721,40656572
Russia,2020-07-26,2054218,45117,2009101,40898086
Russia,2020-07-27,2067729,45413,2022316,41138099
Russia,2020-07-28,2078199,45643,2032556,41376580
Russia,2020-07-29,2091008,45925,2045083,41613501
Russia,2020-07-30,2100574,46135,2054439,41848831
Russia,2020-07-31,2112770,46403,2066367,42082541
Russia,2020-08-01,2127172,46719,2080453,42314601
Russia,2020-08-02,2135342,46898,2088444,42544982
Russia,2020-08-03,2149825,47217,2102608,42773654
Russia,2020-08-04,2159275,47424,2111851,43000588
Russia,2020-08-05,2168696,47631,2121065,43225754
Russia,2020-08-06,2178956,47856,2131100,43449124
Russia,2020-08-07,2195858,48228,2147630,43670668
Russia,2020-08-08,2201911,48361,2153550,43890356
Russia,2020-08-09,2215472,48658,2166814,44108161
Russia,2020-08-10,2226861,48909,2177952,44324053
Russia,2020-08-11,2235109,49090,2186019,44538003
Russia,2020-08-12,2246800,49346,2197454,44749982
Russia,2020-08-13,2258787,49610,2209177,44959962
Russia,2020-08-14,2268896,49832,2219064,45167914
Russia,2020-08-15,2278072,50033,2228039,45373810
Russia,2020-08-16,2289261,50279,2238982,45577621
Russia,2020-08-17,2298832,50489,2248343,45779319
Russia,2020-08-18,2307523,50680,2256843,45978875
Russia,2020-08-19,2320539,50966,2269573,46176262
Russia,2020-08-20,2328829,51148,2277681,46371452
Russia,2020-08-21,2335465,51294,2284171,46564416
Russia,2020-08-22,2348428,51579,2296849,46755127
Russia,2020-08-23,2356167,51748,2304419,46943557
Russia,2020-08-24,2365926,51963,2313963,47129679
Russia,2020-08-25,2375527,52174,2323353,47313465
Russia,2020-08-26,2383405,52347,2331058,47494887
Russia,2020-08-27,2396121,52626,2343495,47673919
Russia,2020-08-28,2400116,52714,2347402,47850533
Russia,2020-08-29,2411062,52954,2358108,48024703
Russia,2020-08-30,2420095,53153,2366942,48196401
Russia,2020-08-31,2428033,53327,2374706,48365601
Russia,2020-09-01,2436001,53502,2382499,48532276
Russia,2020-09-02,2443909,53676,2390233,48696399
Russia,2020-09-03,2451337,53839,2397498,48857945
Russia,2020-09-04,2459231,54012,2405219,49016887
Russia,2020-09-05,2469907,54247,2415660,49173199
Russia,2020-09-06,2475226,54363,2420863,49326855
Russia,2020-09-07,2486502,54611,2431891,49477829
Russia,2020-09-08,2491751,54726,2437025,49626096
Russia,2020-09-09,2494129,54779,2439350,49771629
Russia,2020-09-10,2506419,55049,2451370,49914405
Russia,2020-09-11,2512022,55172,2456850,50054397
Russia,2020-09-12,2516900,55279,2461621,50191580
Russia,2020-09-13,2527518,55512,2472006,50325930
Russia,2020-09-14,2531521,55600,2475921,50457421
Russia,2020-09-15,2537795,55738,2482057,50586029
Russia,2020-09-16,2545356,55904,2489452,50711731
Russia,2020-09-17,2552582,56062,2496520,50834500
Russia,2020-09-18,2557037,56160,2500877,50954314
Russia,2020-09-19,2562741,56286,2506455,51071148
Russia,2020-09-20,2567320,56386,2510934,51184979
Russia,2020-09-21,2575486,56565,2518921,51295783
Russia,2020-09-22,2579376,56651,2522725,51403536
Russia,2020-09-23,2584066,56754,2527312,51508215
Russia,2020-09-24,2588929,56861,2532068,51609798
Russia,2020-09-25,2595825,57012,2538813,51708260
Russia,2020-09-26,2598674,57075,2541599,51803580
Russia,2020-09-27,2605130,57217,2547913,51895735
Russia,2020-09-28,2607351,57265,2550086,51984703
Russia,2020-09-29,2613344,57397,2555947,52070461
Russia,2020-09-30,2616681,57470,2559211,52152987
Russia,2020-10-01,2618918,57519,2561399,52232260
Russia,2020-10-02,2623940,57630,2566310,52308257
Russia,2020-10-03,2624467,57641,2566826,52380958
Russia,2020-10-04,2630008,57763,2572245,52450342
Russia,2020-10-05,2632055,57808,2574247,52516386
Russia,2020-10-06,2640367,57990,2582377,52579071
Russia,2020-10-07,2638093,57940,2580153,52638375
Russia,2020-10-08,2646907,58134,2588773,52694279
Russia,2020-10-09,2646468,58124,2588344,52746762
Russia,2020-10-10,2647372,58144,2589228,52795804
Russia,2020-10-11,2651544,58236,2593308,52841385
Russia,2020-10-12,2651490,58235,2593255,52883485
Russia,2020-10-13,2652263,58252,2594011,52922086
Russia,2020-10-14,2656148,58337,2597811,52957167
Russia,2020-10-15,2658589,58391,2600198,52988711
Russia,2020-10-16,2660790,58439,2602351,53016697
Russia,2020-10-17,2660829,58440,2602389,53041109
Russia,2020-10-18,2660328,58429,2601899,53061926
Russia,2020-10-19,2663941,58508,2605433,53079132
Russia,2020-10-20,2664251,58515,2605736,53092708
Russia,2020-10-21,2663399,58496,2604903,53102636
Russia,2020-10-22,2665043,58532,2606511,53108900
Russia,2020-10-23,2666549,58565,2607984,53111482
Russia,2020-10-24,2662468,58476,2603992,53110365
Russia,2020-10-25,2661662,58458,2603204,53105532
Russia,2020-10-26,2661666,58458,2603208,53096967
Russia,2020-10-27,2659871,58419,2601452,53084653
Russia,2020-10-28,2661855,58462,2603393,53068574
Russia,2020-10-29,2657604,58369,2599235,53048716
Russia,2020-10-30,2660571,58434,2602137,53025061
Russia,2020-10-31,2656325,58341,2597984,52997594
Russia,2020-11-01,2657678,58371,2599307,52966302
Russia,2020-11-02,2650161,58206,2591955,52931168
Russia,2020-11-03,2651334,58231,2593103,52892178
Russia,2020-11-04,2647819,58154,2589665,52849317
Russia,2020-11-05,2649297,58187,2591110,52802572
Russia,2020-11-06,2647193,58140,2589053,52751929
Russia,2020-11-07,2638547,57950,2580597,52697374
Russia,2020-11-08,2640260,57988,2582272,52638894
Russia,2020-11-09,2637387,57925,2579462,52576475
Russia,2020-11-10,2632937,57827,2575110,52510105
Russia,2020-11-11,2629755,57757,2571998,52439772
Russia,2020-11-12,2625886,57672,2568214,52365461
Russia,2020-11-13,2622439,57597,2564842,52287163
Russia,2020-11-14,2615412,57442,2557970,52204864
Russia,2020-11-15,2614394,57420,2556974,52118554
Russia,2020-11-16,2608382,57288,2551094,52028220
Russia,2020-11-17,2603527,57181,2546346,51933853
Russia,2020-11-18,2599166,57086,2542080,51835440
Russia,2020-11-19,2591312,56913,2534399,51732972
Russia,2020-11-20,2585524,56786,2528738,51626438
Russia,2020-11-21,2582034,56709,2525325,51515829
Russia,2020-11-22,2578679,56636,2522043,51401134
Russia,2020-11-23,2568707,56417,2512290,51282344
Russia,2020-11-24,2564498,56324,2508174,51159450
Russia,2020-11-25,2556796,56155,2500641,51032443
Russia,2020-11-26,2549993,56006,2493987,50901315
Russia,2020-11-27,2545153,55899,2489254,50766057
Russia,2020-11-28,2538510,55753,2482757,50626660
Russia,2020-11-29,2529025,55545,2473480,50483118
Russia,2020-11-30,2524763,55451,2469312,50335422
Russia,2020-12-01,2515712,55253,2460459,50183566
Russia,2020-12-02,2506890,55059,2451831,50027542
Russia,2020-12-03,2499689,54901,2444788,49867344
Russia,2020-12-04,2493884,54773,2439111,49702965
Russia,2020-12-05,2483532,54546,2428986,49534399
Russia,2020-12-06,2472724,54308,2418416,49361640
Russia,2020-12-07,2464817,54135,2410682,49184683
Russia,2020-12-08,2455927,53940,2401987,49003523
Russia,2020-12-09,2447386,53752,2393634,48818154
Russia,2020-12-10,2437234,53529,2383705,48628572
Russia,2020-12-11,2429909,53368,2376541,48434772
Russia,2020-12-12,2416860,53082,2363778,48236751
Russia,2020-12-13,2404502,52810,2351692,48034504
Russia,2020-12-14,2396964,52645,2344319,47828027
Russia,2020-12-15,2385420,52391,2333029,47617319
Russia,2020-12-16,2373070,52120,2320950,47402374
Russia,2020-12-17,2363227,51904,2311323,47183192
Russia,2020-12-18,2352508,51668,2300840,46959770
Russia,2020-12-19,2343259,51465,2291794,46732105
Russia,2020-12-20,2327784,51125,2276659,46500195
Russia,2020-12-21,2318599,50923,2267676,46264040
Russia,2020-12-22,2309257,50718,2258539,46023638
Russia,2020-12-23,2293477,50372,2243105,45778988
Russia,2020-12-24,2280937,50096,2230841,45530090
Russia,2020-12-25,2269576,49847,2219729,45276942
Russia,2020-12-26,2256366,49557,2206809,45019546
Russia,2020-12-27,2244538,49297,2195241,44757902
Russia,2020-12-28,2228879,48953,2179926,44492009
Russia,2020-12-29,2216589,48683,2167906,44221870
Russia,2020-12-30,2202841,48381,2154460,43947484
Russia,2020-12-31,2187319,48040,2139279,43668855
Russia,2021-01-01,2173447,47735,2125712,43385982
Russia,2021-01-02,2159190,47422,2111768,43098870
Russia,2021-01-03,2142780,47062,2095718,42807519
Russia,2021-01-04,2129188,46763,2082425,42511933
Russia,2021-01-05,2116896,46493,2070403,42212114
Russia,2021-01-06,2100973,46144,2054829,41908067
Russia,2021-01-07,2083146,45752,2037394,41599794
Russia,2021-01-08,2068293,45426,2022867,41287300
Russia,2021-01-09,2053846,45109,2008737,40970588
Russia,2021-01-10,2036978,44738,1992240,40649664
Russia,2021-01-11,2021190,44391,1976799,40324531
Russia,2021-01-12,2004284,44020,1960264,39995196
Russia,2021-01-13,1987090,43642,1943448,39661664
Russia,2021-01-14,1969596,43258,1926338,39323939
Russia,2021-01-15,1950947,42849,1908098,38982030
Russia,2021-01-16,1936346,42528,1893818,38635941
Russia,2021-01-17,1917448,42113,1875335,38285680
Russia,2021-01-18,1897594,41677,1855917,37931253
Russia,2021-01-19,1881222,41317,1839905,37572667
Russia,2021-01-20,1865074,40963,1824111,37209932
Russia,2021-01-21,1842639,40470,1802169,36843053
Russia,2021-01-22,1825332,40090,1785242,36472040
Russia,2021-01-23,1808226,39714,1768512,36096900
Russia,2021-01-24,1791064,39337,1751727,35717644
Russia,2021-01-25,1771253,38902,1732351,35334279
Russia,2021-01-26,1752562,38491,1714071,34946815
Russia,2021-01-27,1731045,38019,1693026,34555263
Russia,2021-01-28,1710605,37570,1673035,34159631
Russia,2021-01-29,1692106,37164,1654942,33759931
Russia,2021-01-30,1669325,36663,1632662,33356173
Russia,2021-01-31,1648771,36212,1612559,32948368
Russia,2021-02-01,1627869,35753,1592116,32536528
Russia,2021-02-02,1610301,35367,1574934,32120663
Russia,2021-02-03,1586451,34843,1551608,31700786
Russia,2021-02-04,1567886,34435,1533451,31276908
Russia,2021-02-05,1545199,33937,1511262,30849044
Russia,2021-02-06,1524949,33492,1491457,30417204
Russia,2021-02-07,1499889,32942,1466947,29981403
Russia,2021-02-08,1478553,32473,1446080,29541653
Russia,2021-02-09,1457896,32020,1425876,29097969
Russia,2021-02-10,1434175,31499,1402676,28650364
Russia,2021-02-11,1408541,30936,1377605,28198853
Russia,2021-02-12,1387359,30470,1356889,27743450
Russia,2021-02-13,1364725,29973,1334752,27284171
Russia,2021-02-14,1341628,29466,1312162,26821030
Russia,2021-02-15,1320742,29007,1291735,26354043
Russia,2021-02-16,1296650,28478,1268172,25883226
Russia,2021-02-17,1272616,27950,1244666,25408595
Russia,2021-02-18,1251342,27483,1223859,24930167
Russia,2021-02-19,1225968,26926,1199042,24447957
Russia,2021-02-20,1201078,26379,1174699,23961984
Russia,2021-02-21,1173192,25767,1147425,23472265
Russia,2021-02-22,1150742,25273,1125469,22978816
Russia,2021-02-23,1126187,24734,1101453,22481657
Russia,2021-02-24,1100056,24160,1075896,21980805
Russia,2021-02-25,1077880,23673,1054207,21476278
Russia,2021-02-26,1050009,23061,1026948,20968097
Russia,2021-02-27,1022506,22457,1000049,20456279
Russia,2021-02-28,997025,21897,975128,19940845
Russia,2021-03-01,975815,21432,954383,19421813
Russia,2021-03-02,945695,20770,924925,18899204
Russia,2021-03-03,916922,20138,896784,18373039
Russia,2021-03-04,892551,19603,872948,17843337
Russia,2021-03-05,864054,18977,845077,17310120
Russia,2021-03-06,841179,18474,822705,16773409
Russia,2021-03-07,809934,17788,792146,16233225
Russia,2021-03-08,783515,17208,766307,15689590
Russia,2021-03-09,758170,16651,741519,15142526
Russia,2021-03-10,732216,16081,716135,14592055
Russia,2021-03-11,702760,15434,687326,14038201
Russia,2021-03-12,673122,14783,658339,13480985
Russia,2021-03-13,647154,14213,632941,12920431
Russia,2021-03-14,617969,13572,604397,12356563
Russia,2021-03-15,591904,13000,578904,11789404
Russia,2021-03-16,562935,12363,550572,11218978
Russia,2021-03-17,532179,11688,520491,10645310
Russia,2021-03-18,505215,11096,494119,10068424
Russia,2021-03-19,475427,10441,464986,9488346
Russia,2021-03-20,447823,9835,437988,8905099
Russia,2021-03-21,417544,9170,408374,8318710
Russia,2021-03-22,387750,8516,379234,7729204
Russia,2021-03-23,359220,7889,351331,7136607
Russia,2021-03-24,327481,7192,320289,6540946
Russia,2021-03-25,296356,6508,289848,5942247
Russia,2021-03-26,267652,5878,261774,5340536
Russia,2021-03-27,236566,5195,231371,4735842
Russia,2021-03-28,207545,4558,202987,4128190
Russia,2021-03-29,176185,3869,172316,3517609
Russia,2021-03-30,145970,3205,142765,2904127
Russia,2021-03-31,112769,2476,110293,2287772
Russia,2021-04-01,84270,1850,82420,1668571
Russia,2021-04-02,50514,1109,49405,1046555
Russia,2021-04-03,22516,494,22022,421750
Russia,2021-04-04,8897,195,8702,205811
Russia,2021-04-05,41346,908,40438,836102
Russia,2021-04-06,73087,1605,71482,1469092
Russia,2021-04-07,105686,2321,103365,2104752
Russia,2021-04-08,138191,3035,135156,2743050
Russia,2021-04-09,169413,3720,165693,3383958
Russia,2021-04-10,198708,4364,194344,4027443
Russia,2021-04-11,233603,5130,228473,4673475
Russia,2021-04-12,268364,5894,262470,5322022
Russia,2021-04-13,301480,6621,294859,5973054
Russia,2021-04-14,333794,7331,326463,6626539
Russia,2021-04-15,365076,8018,357058,7282445
Russia,2021-04-16,395626,8689,386937,7940739
Russia,2021-04-17,432033,9488,422545,8601389
Russia,2021-04-18,461646,10139,451507,9264363
Russia,2021-04-19,496755,10910,485845,9929628
Russia,2021-04-20,529720,11634,518086,10597150
Russia,2021-04-21,563280,12371,550909,11266896
Russia,2021-04-22,596712,13105,583607,11938833
Russia,2021-04-23,631911,13878,618033,12612927
Russia,2021-04-24,668560,14683,653877,13289144
Russia,2021-04-25,699958,15373,684585,13967449
Russia,2021-04-26,734444,16130,718314,14647808
Russia,2021-04-27,766844,16842,750002,15330187
Russia,2021-04-28,801226,17597,783629,16014550
Russia,2021-04-29,836289,18367,817922,16700862
Russia,2021-04-30,867770,19059,848711,17389088
Russia,2021-05-01,905802,19894,885908,18079193
Russia,2021-05-02,942741,20705,922036,18771140
Russia,2021-05-03,974035,21392,952643,19464893
Russia,2021-05-04,1007279,22123,985156,20160417
Russia,2021-05-05,1043486,22918,1020568,20857674
Russia,2021-05-06,1079401,23707,1055694,21556629
Russia,2021-05-07,1113588,24457,1089131,22257244
Russia,2021-05-08,1146394,25178,1121216,22959482
Russia,2021-05-09,1185572,26038,1159534,23663307
Russia,2021-05-10,1219545,26785,1192760,24368680
Russia,2021-05-11,1253983,27541,1226442,25075564
Russia,2021-05-12,1290034,28333,1261701,25783921
Russia,2021-05-13,1326281,29129,1297152,26493713
Russia,2021-05-14,1362126,29916,1332210,27204901
Russia,2021-05-15,1397572,30695,1366877,27917449
Russia,2021-05-16,1432098,31453,1400645,28631316
Russia,2021-05-17,1467964,32241,1435723,29346464
Russia,2021-05-18,1501442,32976,1468466,30062854
Russia,2021-05-19,1542645,33881,1508764,30780447
Russia,2021-05-20,1573798,34565,1539233,31499203
Russia,2021-05-21,1612678,35419,1577259,32219084
Russia,2021-05-22,1648583,36208,1612375,32940049
Russia,2021-05-23,1683320,36971,1646349,33662058
Russia,2021-05-24,1719502,37765,1681737,34385072
Russia,2021-05-25,1755279,38551,1716728,35109051
Russia,2021-05-26,1791227,39341,1751886,35833953
Russia,2021-05-27,1829601,40183,1789418,36559738
Russia,2021-05-28,1863870,40936,1822934,37286366
Russia,2021-05-29,1903205,41800,1861405,38013796
Russia,2021-05-30,1939162,42590,1896572,38741987
Russia,2021-05-31,1975447,43387,1932060,39470898
Russia,2021-06-01,2012449,44199,1968250,40200487
Russia,2021-06-02,2048123,44983,2003140,40930713
Russia,2021-06-03,2083462,45759,2037703,41661534
Russia,2021-06-04,2120406,46570,2073836,42392909
Russia,2021-06-05,2158864,47415,2111449,43124795
Russia,2021-06-06,2195620,48222,2147398,43857151
Russia,2021-06-07,2232509,49033,2183476,44589934
Russia,2021-06-08,2267807,49808,2217999,45323103
Russia,2021-06-09,2306936,50667,2256269,46056614
Russia,2021-06-10,2342635,51451,2291184,46790425
Russia,2021-06-11,2378724,52244,2326480,47524493
Russia,2021-06-12,2413244,53002,2360242,48258776
Russia,2021-06-13,2451716,53847,2397869,48993231
Russia,2021-06-14,2486799,54618,2432181,49727814
Russia,2021-06-15,2524741,55451,2469290,50462482
Russia,2021-06-16,2562457,56279,2506178,51197192
Russia,2021-06-17,2599146,57085,2542061,51931901
Russia,2021-06-18,2636963,57916,2579047,52666564
Russia,2021-06-19,2668496,58608,2609888,53401139
Russia,2021-06-20,2707117,59456,2647661,54135582
Russia,2021-06-21,2744583,60279,2684304,54869847
Russia,2021-06-22,2784081,61147,2722934,55603893
Russia,2021-06-23,2819539,61926,2757613,56337674
Russia,2021-06-24,2856988,62748,2794240,57071147
Russia,2021-06-25,2892046,63518,2828528,57804266
Russia,2021-06-26,2930233,64357,2865876,58536988
Russia,2021-06-27,2966482,65153,2901329,59269269
Russia,2021-06-28,3003419,65964,2937455,60001064
Russia,2021-06-29,3039027,66746,2972281,60732327
Russia,2021-06-30,3075117,67539,3007578,61463015
Russia,2021-07-01,3112046,68350,3043696,62193083
Russia,2021-07-02,3145976,69095,3076881,62922485
Russia,2021-07-03,3183473,69919,3113554,63651177
Russia,2021-07-04,3222205,70769,3151436,64379114
Russia,2021-07-05,3256952,71533,3185419,65106251
Russia,2021-07-06,3294772,72363,3222409,65832542
Russia,2021-07-07,3330604,73150,3257454,66557943
Russia,2021-07-08,3365558,73918,3291640,67282408
Russia,2021-07-09,3401467,74707,3326760,68005891
Russia,2021-07-10,3439425,75540,3363885,68728348
Russia,2021-07-11,3476256,76349,3399907,69449733
Russia,2021-07-12,3510535,77102,3433433,70170000
Russia,2021-07-13,3545989,77881,3468108,70889105
Russia,2021-07-14,3583455,78704,3504751,71607000
Russia,2021-07-15,3617169,79444,3537725,72323642
Russia,2021-07-16,3653199,80235,3572964,73038983
Russia,2021-07-17,3690789,81061,3609728,73752979
Russia,2021-07-18,3723821,81787,3642034,74465583
Russia,2021-07-19,3759339,82567,3676772,75176751
Russia,2021-07-20,3793503,83317,3710186,75886435
Russia,2021-07-21,3829433,84106,3745327,76594590
Russia,2021-07-22,3868580,84966,3783614,77301171
Russia,2021-07-23,3901163,85682,3815481,78006131
Russia,2021-07-24,3936396,86455,3849941,78709425
Russia,2021-07-25,3973270,87265,3886005,79411007
Russia,2021-07-26,4007090,88008,3919082,80110830
Russia,2021-07-27,4045396,88849,3956547,80808849
Russia,2021-07-28,4080246,89615,3990631,81505019
Russia,2021-07-29,4114682,90371,4024311,82199292
Russia,2021-07-30,4146229,91064,4055165,82891623
Russia,2021-07-31,4180677,91821,4088856,83581966
Russia,2021-08-01,4216129,92599,4123530,84270276
Russia,2021-08-02,4247529,93289,4154240,84956505
Russia,2021-08-03,4282804,94064,4188740,85640610
Russia,2021-08-04,4320673,94895,4225778,86322542
Russia,2021-08-05,4352576,95596,4256980,87002257
Russia,2021-08-06,4387567,96365,4291202,87679709
Russia,2021-08-07,4419347,97063,4322284,88354851
Russia,2021-08-08,4453633,97816,4355817,89027639
Russia,2021-08-09,4488394,98579,4389815,89698026
Russia,2021-08-10,4518026,99230,4418796,90365966
Russia,2021-08-11,4553685,100013,4453672,91031414
Russia,2021-08-12,4587518,100756,4486762,91694324
Russia,2021-08-13,4620293,101476,4518817,92354650
Russia,2021-08-14,4650442,102138,4548304,93012347
Russia,2021-08-15,4684222,102880,4581342,93667369
Russia,2021-08-16,4718399,103631,4614768,94319671
Russia,2021-08-17,4752082,104370,4647712,94969206
Russia,2021-08-18,4784186,105076,4679110,95615931
Russia,2021-08-19,4815857,105771,4710086,96259799
Russia,2021-08-20,4846456,106443,4740013,96900764
Russia,2021-08-21,4877988,107136,4770852,97538783
Russia,2021-08-22,4911896,107880,4804016,98173808
Russia,2021-08-23,4941262,108525,4832737,98805797
Russia,2021-08-24,4975195,109271,4865924,99434702
Russia,2021-08-25,5006044,109948,4896096,100060480
Russia,2021-08-26,5038390,110659,4927731,100683085
Russia,2021-08-27,5069395,111340,4958055,101302473
Russia,2021-08-28,5099377,111998,4987379,101918599
Russia,2021-08-29,5128706,112642,5016064,102531418
Russia,2021-08-30,5160584,113342,5047242,103140885
Russia,2021-08-31,5187243,113928,5073315,103746956
Russia,2021-09-01,5220913,114668,5106245,104349587
Russia,2021-09-02,5249232,115289,5133943,104948734
Russia,2021-09-03,5277346,115907,5161439,105544351
Russia,2021-09-04,5308731,116596,5192135,106136395
Russia,2021-09-05,5338809,117257,5221552,106724823
Russia,2021-09-06,5367292,117882,5249410,107309589
Russia,2021-09-07,5397369,118543,5278826,107890651
Russia,2021-09-08,5426866,119191,5307675,108467964
Russia,2021-09-09,5453177,119769,5333408,109041485
Russia,2021-09-10,5483396,120432,5362964,109611171
Russia,2021-09-11,5509457,121005,5388452,110176978
Russia,2021-09-12,5537745,121626,5416119,110738863
Russia,2021-09-13,5566549,122259,5444290,111296783
Russia,2021-09-14,5593060,122841,5470219,111850695
Russia,2021-09-15,5622752,123493,5499259,112400556
Russia,2021-09-16,5648091,124050,5524041,112946323
Russia,2021-09-17,5675168,124644,5550524,113487954
Russia,2021-09-18,5703604,125269,5578335,114025407
Russia,2021-09-19,5730440,125858,5604582,114558639
Russia,2021-09-20,5755769,126415,5629354,115087608
Russia,2021-09-21,5779597,126938,5652659,115612272
Russia,2021-09-22,5808811,127580,5681231,116132589
Russia,2021-09-23,5834913,128153,5706760,116648517
Russia,2021-09-24,5858097,128662,5729435,117160016
Russia,2021-09-25,5885055,129254,5755801,117667043
Russia,2021-09-26,5909003,129780,5779223,118169558
Russia,2021-09-27,5932999,130307,5802692,118667519
Russia,2021-09-28,5962588,130957,5831631,119160886
Russia,2021-09-29,5984282,131434,5852848,119649617
Russia,2021-09-30,6008751,131971,5876780,120133673
Russia,2021-10-01,6033772,132520,5901252,120613012
Russia,2021-10-02,6058882,133072,5925810,121087596
Russia,2021-10-03,6081879,133577,5948302,121557383
Russia,2021-10-04,6102637,134033,5968604,122022334
Russia,2021-10-05,6126557,134558,5991999,122482410
Russia,2021-10-06,6149690,135066,6014624,122937570
Russia,2021-10-07,6170877,135532,6035345,123387776
Russia,2021-10-08,6194269,136046,6058223,123832989
Russia,2021-10-09,6213369,136465,6076904,124273169
Russia,2021-10-10,6237898,137004,6100894,124708279
Russia,2021-10-11,6256279,137407,6118872,125138279
Russia,2021-10-12,6279745,137923,6141822,125563132
Russia,2021-10-13,6301620,138403,6163217,125982799
Russia,2021-10-14,6322431,138860,6183571,126397242
Russia,2021-10-15,6339607,139238,6200369,126806424
Russia,2021-10-16,6360978,139707,6221271,127210308
Russia,2021-10-17,6383012,140191,6242821,127608856
Russia,2021-10-18,6401371,140594,6260777,128002032
Russia,2021-10-19,6424358,141099,6283259,128389798
Russia,2021-10-20,6441958,141486,6300472,128772118
Russia,2021-10-21,6459934,141880,6318054,129148957
Russia,2021-10-22,6478518,142289,6336229,129520277
Russia,2021-10-23,6493887,142626,6351261,129886042
Russia,2021-10-24,6516442,143121,6373321,130246219
Russia,2021-10-25,6533441,143495,6389946,130600770
Russia,2021-10-26,6548124,143817,6404307,130949661
Russia,2021-10-27,6565590,144201,6421389,131292857
Russia,2021-10-28,6583291,144590,6438701,131630324
Russia,2021-10-29,6596352,144877,6451475,131962027
Russia,2021-10-30,6614723,145280,6469443,132287932
Russia,2021-10-31,6629824,145612,6484212,132608005
Russia,2021-11-01,6647375,145997,6501378,132922212
Russia,2021-11-02,6663490,146351,6517139,133230521
Russia,2021-11-03,6678573,146682,6531891,133532897
Russia,2021-11-04,6691245,146961,6544284,133829309
Russia,2021-11-05,6705972,147284,6558688,134119724
Russia,2021-11-06,6721619,147628,6573991,134404109
Russia,2021-11-07,6734509,147911,6586598,134682432
Russia,2021-11-08,6747384,148194,6599190,134954662
Russia,2021-11-09,6762898,148534,6614364,135220767
Russia,2021-11-10,6775554,148812,6626742,135480716
Russia,2021-11-11,6787070,149065,6638005,135734479
Russia,2021-11-12,6802689,149408,6653281,135982023
Russia,2021-11-13,6811445,149601,6661844,136223320
Russia,2021-11-14,6825497,149909,6675588,136458339
Russia,2021-11-15,6833897,150094,6683803,136687050
Russia,2021-11-16,6843236,150299,6692937,136909424
Russia,2021-11-17,6858168,150627,6707541,137125431
Russia,2021-11-18,6869581,150878,6718703,137335044
Russia,2021-11-19,6878013,151063,6726950,137538232
Russia,2021-11-20,6887955,151281,6736674,137734968
Russia,2021-11-21,6896096,151460,6744636,137925224
Russia,2021-11-22,6905886,151675,6754211,138108972
Russia,2021-11-23,6915501,151886,6763615,138286185
Russia,2021-11-24,6923448,152061,6771387,138456836
Russia,2021-11-25,6933401,152279,6781122,138620898
Russia,2021-11-26,6938406,152389,6786017,138778344
Russia,2021-11-27,6944774,152529,6792245,138929149
Russia,2021-11-28,6956070,152777,6803293,139073286
Russia,2021-11-29,6963479,152940,6810539,139210731
Russia,2021-11-30,6968277,153045,6815232,139341457
Russia,2021-12-01,6975652,153207,6822445,139465440
Russia,2021-12-02,6981572,153337,6828235,139582657
Russia,2021-12-03,6987257,153462,6833795,139693081
Russia,2021-12-04,6990653,153537,6837116,139796690
Russia,2021-12-05,6995790,153649,6842141,139893460
Russia,2021-12-06,6999120,153723,6845397,139983368
Russia,2021-12-07,7004617,153843,6850774,140066391
Russia,2021-12-08,7009356,153947,6855409,140142507
Russia,2021-12-09,7011044,153985,6857059,140211692
Russia,2021-12-10,7015656,154086,6861570,140273927
Russia,2021-12-11,7016107,154096,6862011,140329188
Russia,2021-12-12,7021679,154218,6867461,140377455
Russia,2021-12-13,7024449,154279,6870170,140418707
Russia,2021-12-14,7025330,154298,6871032,140452923
Russia,2021-12-15,7024929,154289,6870640,140480084
Russia,2021-12-16,7025722,154307,6871415,140500170
Russia,2021-12-17,7025732,154307,6871425,140513161
Russia,2021-12-18,7027030,154336,6872694,140519039
Russia,2021-12-19,7027359,154343,6873016,140517784
Russia,2021-12-20,7023592,154260,6869332,140509378
Russia,2021-12-21,7023179,154251,6868928,140493804
Russia,2021-12-22,7022288,154231,6868057,140471043
Russia,2021-12-23,7021758,154220,6867538,140441079
Russia,2021-12-24,7019763,154176,6865587,140403895
Russia,2021-12-25,7019265,154165,6865100,140359474
Russia,2021-12-26,7015276,154077,6861199,140307800
Russia,2021-12-27,7013891,154047,6859844,140248857
Russia,2021-12-28,7010726,153978,6856748,140182630
Russia,2021-12-29,7007854,153914,6853940,140109105
Russia,2021-12-30,7000839,153760,6847079,140028265
Russia,2021-12-31,6996766,153671,6843095,139940098
United Kingdom,2020-01-01,377,11,366,0
United Kingdom,2020-01-02,429,12,417,636
United Kingdom,2020-01-03,521,15,506,2547
United Kingdom,2020-01-04,1254,37,1217,5732
United Kingdom,2020-01-05,612,18,594,10189
United Kingdom,2020-01-06,85,2,83,15920
United Kingdom,2020-01-07,2140,64,2076,22923
United Kingdom,2020-01-08,2857,86,2771,31198
United Kingdom,2020-01-09,3014,91,2923,40744
United Kingdom,2020-01-10,2879,87,2792,51560
United Kingdom,2020-01-11,4349,131,4218,63645
United Kingdom,2020-01-12,6680,202,6478,76997
United Kingdom,2020-01-13,5207,157,5050,91617
United Kingdom,2020-01-14,5077,153,4924,107502
United Kingdom,2020-01-15,6472,195,6277,124650
United Kingdom,2020-01-16,8259,249,8010,143061
United Kingdom,2020-01-17,7773,235,7538,162732
United Kingdom,2020-01-18,10068,304,9764,183662
United Kingdom,2020-01-19,11364,343,11021,205849
United Kingdom,2020-01-20,13364,404,12960,229290
United Kingdom,2020-01-21,14490,438,14052,253983
United Kingdom,2020-01-22,15528,469,15059,279926
United Kingdom,2020-01-23,14876,449,14427,307117
United Kingdom,2020-01-24,18434,557,17877,335554
United Kingdom,2020-01-25,19814,599,19215,365232
United Kingdom,2020-01-26,21098,638,20460,396150
United Kingdom,2020-01-27,21400,647,20753,428305
United Kingdom,2020-01-28,23759,718,23041,461693
United Kingdom,2020-01-29,25267,764,24503,496312
United Kingdom,2020-01-30,26526,802,25724,532158
United Kingdom,2020-01-31,29787,900,28887,569228
United Kingdom,2020-02-01,31204,943,30261,607518
United Kingdom,2020-02-02,35544,1075,34469,647026
United Kingdom,2020-02-03,35725,1080,34645,687746
United Kingdom,2020-02-04,38855,1175,37680,729675
United Kingdom,2020-02-05,39109,1182,37927,772810
United Kingdom,2020-02-06,42072,1272,40800,817146
United Kingdom,2020-02-07,44815,1355,43460,862679
United Kingdom,2020-02-08,46509,1406,45103,909404
United Kingdom,2020-02-09,49275,1490,47785,957318
United Kingdom,2020-02-10,51908,1570,50338,1006416
United Kingdom,2020-02-11,54451,1646,52805,1056693
United Kingdom,2020-02-12,58481,1768,56713,1108144
United Kingdom,2020-02-13,60149,1819,58330,1160765
United Kingdom,2020-02-14,62946,1903,61043,1214551
United Kingdom,2020-02-15,65773,1989,63784,1269496
United Kingdom,2020-02-16,68666,2076,66590,1325595
United Kingdom,2020-02-17,71095,2150,68945,1382843
United Kingdom,2020-02-18,73891,2234,71657,1441235
United Kingdom,2020-02-19,77237,2336,74901,1500765
United Kingdom,2020-02-20,80980,2449,78531,1561427
United Kingdom,2020-02-21,84086,2543,81543,1623216
United Kingdom,2020-02-22,86341,2611,83730,1686126
United Kingdom,2020-02-23,90264,2730,87534,1750151
United Kingdom,2020-02-24,92904,2810,90094,1815284
United Kingdom,2020-02-25,96408,2916,93492,1881520
United Kingdom,2020-02-26,99466,3008,96458,1948852
United Kingdom,2020-02-27,103122,3119,100003,2017274
United Kingdom,2020-02-28,107667,3256,104411,2086780
United Kingdom,2020-02-29,110384,3338,107046,2157362
United Kingdom,2020-03-01,114031,3449,110582,2229015
United Kingdom,2020-03-02,116628,3527,113101,2301730
United Kingdom,2020-03-03,121124,3663,117461,2375502
United Kingdom,2020-03-04,124946,3779,121167,2450324
United Kingdom,2020-03-05,128375,3882,124493,2526187
United Kingdom,2020-03-06,132832,4017,128815,2603086
United Kingdom,2020-03-07,136456,4127,132329,2681012
United Kingdom,2020-03-08,140783,4258,136525,2759958
United Kingdom,2020-03-09,144843,4381,140462,2839916
United Kingdom,2020-03-10,148193,4482,143711,2920880
United Kingdom,2020-03-11,152702,4618,148084,3002841
United Kingdom,2020-03-12,157206,4754,152452,3085791
United Kingdom,2020-03-13,162186,4905,157281,3169723
United Kingdom,2020-03-14,165834,5015,160819,3254628
United Kingdom,2020-03-15,169536,5127,164409,3340499
United Kingdom,2020-03-16,174630,5281,169349,3427326
United Kingdom,2020-03-17,179939,5442,174497,3515102
United Kingdom,2020-03-18,183869,5561,178308,3603819
United Kingdom,2020-03-19,188132,5690,182442,3693467
United Kingdom,2020-03-20,192812,5831,186981,3784038
United Kingdom,2020-03-21,197902,5985,191917,3875523
United Kingdom,2020-03-22,202305,6119,196186,3967915
United Kingdom,2020-03-23,206654,6250,200404,4061202
United Kingdom,2020-03-24,211733,6404,205329,4155378
United Kingdom,2020-03-25,215056,6504,208552,4250432
United Kingdom,2020-03-26,219596,6642,212954,4346355
United Kingdom,2020-03-27,225590,6823,218767,4443139
United Kingdom,2020-03-28,230441,6970,223471,4540773
United Kingdom,2020-03-29,234977,7107,227870,4639249
United Kingdom,2020-03-30,240901,7286,233615,4738557
United Kingdom,2020-03-31,244110,7383,236727,4838686
United Kingdom,2020-04-01,250086,7564,242522,4939628
United Kingdom,2020-04-02,255235,7720,247515,5041373
United Kingdom,2020-04-03,259608,7852,251756,5143910
United Kingdom,2020-04-04,266926,8073,258853,5247230
United Kingdom,2020-04-05,270220,8173,262047,5351323
United Kingdom,2020-04-06,276012,8348,267664,5456178
United Kingdom,2020-04-07,282335,8539,273796,5561786
United Kingdom,2020-04-08,287500,8695,278805,5668136
United Kingdom,2020-04-09,291689,8822,282867,5775217
United Kingdom,2020-04-10,298320,9023,289297,5883020
United Kingdom,2020-04-11,303504,9180,294324,5991533
United Kingdom,2020-04-12,310377,9387,300990,6100746
United Kingdom,2020-04-13,314587,9515,305072,6210648
United Kingdom,2020-04-14,319770,9672,310098,6321228
United Kingdom,2020-04-15,324871,9826,315045,6432477
United Kingdom,2020-04-16,330566,9998,320568,6544382
United Kingdom,2020-04-17,336161,10167,325994,6656932
United Kingdom,2020-04-18,343335,10384,332951,6770117
United Kingdom,2020-04-19,348130,10529,337601,6883926
United Kingdom,2020-04-20,354245,10714,343531,6998346
United Kingdom,2020-04-21,360663,10908,349755,7113367
United Kingdom,2020-04-22,363836,11004,352832,7228978
United Kingdom,2020-04-23,372137,11255,360882,7345167
United Kingdom,2020-04-24,377165,11408,365757,7461922
United Kingdom,2020-04-25,383310,11593,371717,7579232
United Kingdom,2020-04-26,388366,11746,376620,7697085
United Kingdom,2020-04-27,394355,11927,382428,7815469
United Kingdom,2020-04-28,401165,12133,389032,7934373
United Kingdom,2020-04-29,408443,12354,396089,8053785
United Kingdom,2020-04-30,413520,12507,401013,8173693
United Kingdom,2020-05-01,419737,12695,407042,8294085
United Kingdom,2020-05-02,424810,12849,411961,8414948
United Kingdom,2020-05-03,430618,13024,417594,8536271
United Kingdom,2020-05-04,436603,13205,423398,8658041
United Kingdom,2020-05-05,442930,13397,429533,8780247
United Kingdom,2020-05-06,448017,13551,434466,8902876
United Kingdom,2020-05-07,455089,13764,441325,9025915
United Kingdom,2020-05-08,461390,13955,447435,9149352
United Kingdom,2020-05-09,467860,14151,453709,9273175
United Kingdom,2020-05-10,474295,14345,459950,9397371
United Kingdom,2020-05-11,480696,14539,466157,9521928
United Kingdom,2020-05-12,486701,14721,471980,9646832
United Kingdom,2020-05-13,492595,14899,477696,9772072
United Kingdom,2020-05-14,497951,15061,482890,9897634
United Kingdom,2020-05-15,505202,15280,489922,10023506
United Kingdom,2020-05-16,511256,15463,495793,10149674
United Kingdom,2020-05-17,518570,15685,502885,10276127
United Kingdom,2020-05-18,525222,15886,509336,10402850
United Kingdom,2020-05-19,531605,16079,515526,10529832
United Kingdom,2020-05-20,537857,16268,521589,10657058
United Kingdom,2020-05-21,543640,16443,527197,10784516
United Kingdom,2020-05-22,549773,16628,533145,10912192
United Kingdom,2020-05-23,556028,16818,539210,11040075
United Kingdom,2020-05-24,561928,16996,544932,11168149
United Kingdom,2020-05-25,570050,17242,552808,11296402
United Kingdom,2020-05-26,575692,17412,558280,11424821
United Kingdom,2020-05-27,581405,17585,563820,11553392
United Kingdom,2020-05-28,588137,17789,570348,11682103
United Kingdom,2020-05-29,594563,17983,576580,11810938
United Kingdom,2020-05-30,601640,18197,583443,11939886
United Kingdom,2020-05-31,608799,18414,590385,12068932
United Kingdom,2020-06-01,614305,18580,595725,12198064
United Kingdom,2020-06-02,619483,18737,600746,12327266
United Kingdom,2020-06-03,627357,18975,608382,12456527
United Kingdom,2020-06-04,633854,19172,614682,12585831
United Kingdom,2020-06-05,640284,19366,620918,12715167
United Kingdom,2020-06-06,646487,19554,626933,12844519
United Kingdom,2020-06-07,653538,19767,633771,12973874
United Kingdom,2020-06-08,659911,19960,639951,13103218
United Kingdom,2020-06-09,666324,20154,646170,13232538
United Kingdom,2020-06-10,673093,20358,652735,13361819
United Kingdom,2020-06-11,678990,20537,658453,13491049
United Kingdom,2020-06-12,685418,20731,664687,13620212
United Kingdom,2020-06-13,693146,20965,672181,13749296
United Kingdom,2020-06-14,699046,21143,677903,13878286
United Kingdom,2020-06-15,705678,21344,684334,14007168
United Kingdom,2020-06-16,712394,21547,690847,14135928
United Kingdom,2020-06-17,718356,21727,696629,14264553
United Kingdom,2020-06-18,725059,21930,703129,14393028
United Kingdom,2020-06-19,729778,22073,707705,14521340
United Kingdom,2020-06-20,737401,22304,715097,14649474
United Kingdom,2020-06-21,743540,22489,721051,14777416
United Kingdom,2020-06-22,751195,22721,728474,14905153
United Kingdom,2020-06-23,757066,22898,734168,15032669
United Kingdom,2020-06-24,762377,23059,739318,15159952
United Kingdom,2020-06-25,769414,23272,746142,15286987
United Kingdom,2020-06-26,775617,23459,752158,15413760
United Kingdom,2020-06-27,782140,23657,758483,15540256
United Kingdom,2020-06-28,787453,23817,763636,15666462
United Kingdom,2020-06-29,794688,24036,770652,15792364
United Kingdom,2020-06-30,800570,24214,776356,15917948
United Kingdom,2020-07-01,807182,24414,782768,16043198
United Kingdom,2020-07-02,812746,24582,788164,16168102
United Kingdom,2020-07-03,819069,24774,794295,16292645
United Kingdom,2020-07-04,826473,24998,801475,16416813
United Kingdom,2020-07-05,831153,25139,806014,16540592
United Kingdom,2020-07-06,837373,25327,812046,16663967
United Kingdom,2020-07-07,844150,25532,818618,16786925
United Kingdom,2020-07-08,849788,25703,824085,16909451
United Kingdom,2020-07-09,855816,25885,829931,17031531
United Kingdom,2020-07-10,862569,26089,836480,17153151
United Kingdom,2020-07-11,867533,26240,841293,17274297
United Kingdom,2020-07-12,873903,26432,847471,17394956
United Kingdom,2020-07-13,881989,26677,855312,17515111
United Kingdom,2020-07-14,886887,26825,860062,17634751
United Kingdom,2020-07-15,892023,26980,865043,17753860
United Kingdom,2020-07-16,898740,27184,871556,17872425
United Kingdom,2020-07-17,904740,27365,877375,17990430
United Kingdom,2020-07-18,910900,27551,883349,18107864
United Kingdom,2020-07-19,915978,27705,888273,18224710
United Kingdom,2020-07-20,922537,27903,894634,18340956
United Kingdom,2020-07-21,926269,28016,898253,18456587
United Kingdom,2020-07-22,932683,28210,904473,18571589
United Kingdom,2020-07-23,939226,28408,910818,18685949
United Kingdom,2020-07-24,945020,28583,916437,18799652
United Kingdom,2020-07-25,949826,28729,921097,18912684
United Kingdom,2020-07-26,956234,28923,927311,19025032
United Kingdom,2020-07-27,961213,29073,932140,19136682
United Kingdom,2020-07-28,966991,29248,937743,19247619
United Kingdom,2020-07-29,973380,29441,943939,19357830
United Kingdom,2020-07-30,978770,29604,949166,19467302
United Kingdom,2020-07-31,982907,29729,953178,19576019
United Kingdom,2020-08-01,988258,29891,958367,19683969
United Kingdom,2020-08-02,994049,30066,963983,19791138
United Kingdom,2020-08-03,999623,30235,969388,19897512
United Kingdom,2020-08-04,1004467,30381,974086,20003077
United Kingdom,2020-08-05,1010851,30575,980276,20107821
United Kingdom,2020-08-06,1015569,30717,984852,20211728
United Kingdom,2020-08-07,1020755,30874,989881,20314786
United Kingdom,2020-08-08,1024722,30994,993728,20416981
United Kingdom,2020-08-09,1031433,31197,1000236,20518300
United Kingdom,2020-08-10,1033740,31267,1002473,20618729
United Kingdom,2020-08-11,1041189,31492,1009697,20718254
United Kingdom,2020-08-12,1046179,31643,1014536,20816863
United Kingdom,2020-08-13,1050127,31762,1018365,20914542
United Kingdom,2020-08-14,1056113,31944,1024169,21011278
United Kingdom,2020-08-15,1059987,32061,1027926,21107056
United Kingdom,2020-08-16,1064803,32206,1032597,21201866
United Kingdom,2020-08-17,1069674,32354,1037320,21295692
United Kingdom,2020-08-18,1076239,32552,1043687,21388522
United Kingdom,2020-08-19,1079569,32653,1046916,21480342
United Kingdom,2020-08-20,1083663,32777,1050886,21571141
United Kingdom,2020-08-21,1087045,32879,1054166,21660904
United Kingdom,2020-08-22,1092188,33035,1059153,21749620
United Kingdom,2020-08-23,1095911,33147,1062764,21837274
United Kingdom,2020-08-24,1101339,33311,1068028,21923854
United Kingdom,2020-08-25,1105141,33426,1071715,22009348
United Kingdom,2020-08-26,1108491,33528,1074963,22093742
United Kingdom,2020-08-27,1113462,33678,1079784,22177025
United Kingdom,2020-08-28,1116927,33783,1083144,22259182
United Kingdom,2020-08-29,1121645,33926,1087719,22340203
United Kingdom,2020-08-30,1124941,34025,1090916,22420074
United Kingdom,2020-08-31,1129466,34162,1095304,22498782
United Kingdom,2020-09-01,1133822,34294,1099528,22576316
United Kingdom,2020-09-02,1137081,34393,1102688,22652664
United Kingdom,2020-09-03,1140596,34499,1106097,22727812
United Kingdom,2020-09-04,1144684,34623,1110061,22801749
United Kingdom,2020-09-05,1148642,34742,1113900,22874462
United Kingdom,2020-09-06,1150977,34813,1116164,22945940
United Kingdom,2020-09-07,1155404,34947,1120457,23016170
United Kingdom,2020-09-08,1159556,35072,1124484,23085141
United Kingdom,2020-09-09,1162423,35159,1127264,23152841
United Kingdom,2020-09-10,1165379,35248,1130131,23219257
United Kingdom,2020-09-11,1169016,35358,1133658,23284379
United Kingdom,2020-09-12,1172066,35451,1136615,23348194
United Kingdom,2020-09-13,1175380,35551,1139829,23410691
United Kingdom,2020-09-14,1176538,35586,1140952,23471858
United Kingdom,2020-09-15,1179834,35686,1144148,23531684
United Kingdom,2020-09-16,1184480,35826,1148654,23590158
United Kingdom,2020-09-17,1185616,35861,1149755,23647268
United Kingdom,2020-09-18,1189682,35984,1153698,23703004
United Kingdom,2020-09-19,1191872,36050,1155822,23757353
United Kingdom,2020-09-20,1194066,36116,1157950,23810305
United Kingdom,2020-09-21,1197541,36221,1161320,23861849
United Kingdom,2020-09-22,1199931,36294,1163637,23911973
United Kingdom,2020-09-23,1203645,36406,1167239,23960668
United Kingdom,2020-09-24,1204135,36421,1167714,24007922
United Kingdom,2020-09-25,1207810,36532,1171278,24053725
United Kingdom,2020-09-26,1209272,36576,1172696,24098067
United Kingdom,2020-09-27,1210710,36620,1174090,24140935
United Kingdom,2020-09-28,1213754,36712,1177042,24182321
United Kingdom,2020-09-29,1215573,36767,1178806,24222214
United Kingdom,2020-09-30,1217115,36813,1180302,24260604
United Kingdom,2020-10-01,1219098,36873,1182225,24297480
United Kingdom,2020-10-02,1220262,36909,1183353,24332833
United Kingdom,2020-10-03,1221780,36954,1184826,24366652
United Kingdom,2020-10-04,1224452,37035,1187417,24398928
United Kingdom,2020-10-05,1225302,37061,1188241,24429651
United Kingdom,2020-10-06,1226839,37107,1189732,24458810
United Kingdom,2020-10-07,1228445,37156,1191289,24486398
United Kingdom,2020-10-08,1229717,37195,1192522,24512403
United Kingdom,2020-10-09,1229768,37196,1192572,24536817
United Kingdom,2020-10-10,1232733,37286,1195447,24559631
United Kingdom,2020-10-11,1232984,37293,1195691,24580834
United Kingdom,2020-10-12,1233724,37316,1196408,24600418
United Kingdom,2020-10-13,1235033,37355,1197678,24618375
United Kingdom,2020-10-14,1235697,37375,1198322,24634694
United Kingdom,2020-10-15,1236772,37408,1199364,24649367
United Kingdom,2020-10-16,1237247,37422,1199825,24662386
United Kingdom,2020-10-17,1237918,37443,1200475,24673742
United Kingdom,2020-10-18,1238812,37470,1201342,24683426
United Kingdom,2020-10-19,1238875,37472,1201403,24691430
United Kingdom,2020-10-20,1238461,37459,1201002,24697745
United Kingdom,2020-10-21,1238019,37446,1200573,24702363
United Kingdom,2020-10-22,1240039,37507,1202532,24705277
United Kingdom,2020-10-23,1238785,37469,1201316,24706478
United Kingdom,2020-10-24,1238578,37463,1201115,24705959
United Kingdom,2020-10-25,1237587,37433,1200154,24703710
United Kingdom,2020-10-26,1238776,37469,1201307,24699726
United Kingdom,2020-10-27,1238340,37455,1200885,24693998
United Kingdom,2020-10-28,1236815,37409,1199406,24686518
United Kingdom,2020-10-29,1237669,37435,1200234,24677280
United Kingdom,2020-10-30,1236451,37398,1199053,24666277
United Kingdom,2020-10-31,1237956,37444,1200512,24653500
United Kingdom,2020-11-01,1234993,37354,1197639,24638943
United Kingdom,2020-11-02,1234246,37331,1196915,24622599
United Kingdom,2020-11-03,1233019,37294,1195725,24604462
United Kingdom,2020-11-04,1233462,37308,1196154,24584524
United Kingdom,2020-11-05,1231232,37240,1193992,24562779
United Kingdom,2020-11-06,1229793,37197,1192596,24539221
United Kingdom,2020-11-07,1229474,37187,1192287,24513843
United Kingdom,2020-11-08,1226675,37102,1189573,24486639
United Kingdom,2020-11-09,1226562,37099,1189463,24457603
United Kingdom,2020-11-10,1225781,37075,1188706,24426729
United Kingdom,2020-11-11,1223299,37000,1186299,24394011
United Kingdom,2020-11-12,1221596,36949,1184647,24359443
United Kingdom,2020-11-13,1219910,36898,1183012,24323020
United Kingdom,2020-11-14,1218543,36857,1181686,24284736
United Kingdom,2020-11-15,1216174,36785,1179389,24244586
United Kingdom,2020-11-16,1213527,36705,1176822,24202565
United Kingdom,2020-11-17,1211625,36647,1174978,24158667
United Kingdom,2020-11-18,1208098,36541,1171557,24112887
United Kingdom,2020-11-19,1206820,36502,1170318,24065221
United Kingdom,2020-11-20,1203109,36390,1166719,24015663
United Kingdom,2020-11-21,1200947,36324,1164623,23964210
United Kingdom,2020-11-22,1196413,36187,1160226,23910856
United Kingdom,2020-11-23,1195992,36174,1159818,23855597
United Kingdom,2020-11-24,1192401,36066,1156335,23798429
United Kingdom,2020-11-25,1190615,36012,1154603,23739348
United Kingdom,2020-11-26,1187052,35904,1151148,23678349
United Kingdom,2020-11-27,1184381,35823,1148558,23615430
United Kingdom,2020-11-28,1179616,35679,1143937,23550585
United Kingdom,2020-11-29,1177695,35621,1142074,23483812
United Kingdom,2020-11-30,1174961,35538,1139423,23415107
United Kingdom,2020-12-01,1170494,35403,1135091,23344466
United Kingdom,2020-12-02,1166859,35293,1131566,23271886
United Kingdom,2020-12-03,1162688,35167,1127521,23197365
United Kingdom,2020-12-04,1158370,35036,1123334,23120899
United Kingdom,2020-12-05,1155298,34944,1120354,23042485
United Kingdom,2020-12-06,1149717,34775,1114942,22962121
United Kingdom,2020-12-07,1146316,34672,1111644,22879804
United Kingdom,2020-12-08,1141160,34516,1106644,22795532
United Kingdom,2020-12-09,1137549,34407,1103142,22709302
United Kingdom,2020-12-10,1134029,34300,1099729,22621111
United Kingdom,2020-12-11,1129405,34160,1095245,22530959
United Kingdom,2020-12-12,1124467,34011,1090456,22438843
United Kingdom,2020-12-13,1119820,33870,1085950,22344762
United Kingdom,2020-12-14,1113597,33682,1079915,22248713
United Kingdom,2020-12-15,1109700,33564,1076136,22150695
United Kingdom,2020-12-16,1104466,33406,1071060,22050707
United Kingdom,2020-12-17,1099359,33252,1066107,21948748
United Kingdom,2020-12-18,1094993,33120,1061873,21844816
United Kingdom,2020-12-19,1088683,32929,1055754,21738910
United Kingdom,2020-12-20,1083438,32770,1050668,21631030
United Kingdom,2020-12-21,1076915,32573,1044342,21521175
United Kingdom,2020-12-22,1072516,32440,1040076,21409344
United Kingdom,2020-12-23,1066263,32251,1034012,21295538
United Kingdom,2020-12-24,1061242,32099,1029143,21179755
United Kingdom,2020-12-25,1054630,31899,1022731,21061995
United Kingdom,2020-12-26,1049336,31739,1017597,20942260
United Kingdom,2020-12-27,1043057,31549,1011508,20820547
United Kingdom,2020-12-28,1038082,31398,1006684,20696859
United Kingdom,2020-12-29,1030977,31183,999794,20571195
United Kingdom,2020-12-30,1022984,30941,992043,20443556
United Kingdom,2020-12-31,1016869,30757,986112,20313943
United Kingdom,2021-01-01,1011162,30584,980578,20182356
United Kingdom,2021-01-02,1003791,30361,973430,20048796
United Kingdom,2021-01-03,995607,30113,965494,19913265
United Kingdom,2021-01-04,991639,29993,961646,19775764
United Kingdom,2021-01-05,984214,29769,954445,19636294
United Kingdom,2021-01-06,976982,29550,947432,19494857
United Kingdom,2021-01-07,969022,29309,939713,19351454
United Kingdom,2021-01-08,962432,29110,933322,19206087
United Kingdom,2021-01-09,954273,28863,925410,19058759
United Kingdom,2021-01-10,947402,28655,918747,18909471
United Kingdom,2021-01-11,939052,28403,910649,18758225
United Kingdom,2021-01-12,933022,28220,904802,18605025
United Kingdom,2021-01-13,923145,27922,895223,18449872
United Kingdom,2021-01-14,917169,27741,889428,18292769
United Kingdom,2021-01-15,908382,27475,880907,18133719
United Kingdom,2021-01-16,899950,27220,872730,17972724
United Kingdom,2021-01-17,892225,26986,865239,17809789
United Kingdom,2021-01-18,884342,26748,857594,17644916
United Kingdom,2021-01-19,876408,26508,849900,17478109
United Kingdom,2021-01-20,867232,26230,841002,17309371
United Kingdom,2021-01-21,857858,25947,831911,17138706
United Kingdom,2021-01-22,849847,25705,824142,16966118
United Kingdom,2021-01-23,842293,25476,816817,16791610
United Kingdom,2021-01-24,833130,25199,807931,16615187
United Kingdom,2021-01-25,823892,24920,798972,16436852
United Kingdom,2021-01-26,814780,24644,790136,16256611
United Kingdom,2021-01-27,805584,24366,781218,16074469
United Kingdom,2021-01-28,796670,24096,772574,15890428
United Kingdom,2021-01-29,786254,23781,762473,15704495
United Kingdom,2021-01-30,776229,23478,752751,15516674
United Kingdom,2021-01-31,767688,23220,744468,15326971
United Kingdom,2021-02-01,757484,22911,734573,15135390
United Kingdom,2021-02-02,747627,22613,725014,14941938
United Kingdom,2021-02-03,738065,22324,715741,14746619
United Kingdom,2021-02-04,730359,22091,708268,14549439
United Kingdom,2021-02-05,718790,21741,697049,14350404
United Kingdom,2021-02-06,708876,21441,687435,14149520
United Kingdom,2021-02-07,697641,21101,676540,13946793
United Kingdom,2021-02-08,686968,20778,666190,13742230
United Kingdom,2021-02-09,677322,20486,656836,13535836
United Kingdom,2021-02-10,668420,20217,648203,13327619
United Kingdom,2021-02-11,657147,19876,637271,13117584
United Kingdom,2021-02-12,646711,19560,627151,12905739
United Kingdom,2021-02-13,636102,19240,616862,12692091
United Kingdom,2021-02-14,624404,18886,605518,12476647
United Kingdom,2021-02-15,614864,18597,596267,12259413
United Kingdom,2021-02-16,602519,18224,584295,12040398
United Kingdom,2021-02-17,592842,17931,574911,11819608
United Kingdom,2021-02-18,581038,17574,563464,11597052
United Kingdom,2021-02-19,568285,17188,551097,11372737
United Kingdom,2021-02-20,557667,16867,540800,11146671
United Kingdom,2021-02-21,545551,16501,529050,10918863
United Kingdom,2021-02-22,536053,16213,519840,10689320
United Kingdom,2021-02-23,523661,15839,507822,10458050
United Kingdom,2021-02-24,510495,15440,495055,10225063
United Kingdom,2021-02-25,500506,15138,485368,9990367
United Kingdom,2021-02-26,488045,14761,473284,9753970
United Kingdom,2021-02-27,475477,14381,461096,9515882
United Kingdom,2021-02-28,465614,14083,451531,9276112
United Kingdom,2021-03-01,452454,13685,438769,9034668
United Kingdom,2021-03-02,440006,13308,426698,8791560
United Kingdom,2021-03-03,427675,12935,414740,8546797
United Kingdom,2021-03-04,414577,12539,402038,8300390
United Kingdom,2021-03-05,402296,12168,390128,8052347
United Kingdom,2021-03-06,391550,11843,379707,7802679
United Kingdom,2021-03-07,377771,11426,366345,7551395
United Kingdom,2021-03-08,365443,11053,354390,7298506
United Kingdom,2021-03-09,351296,10625,340671,7044022
United Kingdom,2021-03-10,338965,10252,328713,6787954
United Kingdom,2021-03-11,327372,9901,317471,6530311
United Kingdom,2021-03-12,314234,9504,304730,6271104
United Kingdom,2021-03-13,302110,9137,292973,6010345
United Kingdom,2021-03-14,288697,8732,279965,5748044
United Kingdom,2021-03-15,274417,8300,266117,5484212
United Kingdom,2021-03-16,261608,7912,253696,5218861
United Kingdom,2021-03-17,247709,7492,240217,4952001
United Kingdom,2021-03-18,235882,7134,228748,4683644
United Kingdom,2021-03-19,221756,6707,215049,4413802
United Kingdom,2021-03-20,207506,6276,201230,4142487
United Kingdom,2021-03-21,193869,5863,188006,3869710
United Kingdom,2021-03-22,180983,5474,175509,3595482
United Kingdom,2021-03-23,166594,5038,161556,3319817
United Kingdom,2021-03-24,153385,4639,148746,3042727
United Kingdom,2021-03-25,136894,4140,132754,2764223
United Kingdom,2021-03-26,124683,3771,120912,2484318
United Kingdom,2021-03-27,109937,3325,106612,2203026
United Kingdom,2021-03-28,97328,2943,94385,1920357
United Kingdom,2021-03-29,82966,2509,80457,1636327
United Kingdom,2021-03-30,67651,2046,65605,1350946
United Kingdom,2021-03-31,54318,1642,52676,1064229
United Kingdom,2021-04-01,40066,1211,38855,776188
United Kingdom,2021-04-02,24421,738,23683,486838
United Kingdom,2021-04-03,11499,347,11152,196190
United Kingdom,2021-04-04,4813,145,4668,95739
United Kingdom,2021-04-05,19615,593,19022,388939
United Kingdom,2021-04-06,33621,1016,32605,683394
United Kingdom,2021-04-07,49251,1489,47762,979091
United Kingdom,2021-04-08,63816,1930,61886,1276016
United Kingdom,2021-04-09,77841,2354,75487,1574154
United Kingdom,2021-04-10,93768,2836,90932,1873491
United Kingdom,2021-04-11,109974,3326,106648,2174014
United Kingdom,2021-04-12,123675,3740,119935,2475706
United Kingdom,2021-04-13,139555,4221,135334,2778554
United Kingdom,2021-04-14,153711,4649,149062,3082543
United Kingdom,2021-04-15,169097,5114,163983,3387658
United Kingdom,2021-04-16,183898,5562,178336,3693885
United Kingdom,2021-04-17,199662,6039,193623,4001207
United Kingdom,2021-04-18,214974,6502,208472,4309610
United Kingdom,2021-04-19,231657,7006,224651,4619079
United Kingdom,2021-04-20,246198,7446,238752,4929598
United Kingdom,2021-04-21,261000,7894,253106,5241151
United Kingdom,2021-04-22,278448,8422,270026,5553724
United Kingdom,2021-04-23,292452,8845,283607,5867300
United Kingdom,2021-04-24,309790,9370,300420,6181863
United Kingdom,2021-04-25,325786,9853,315933,6497399
United Kingdom,2021-04-26,340846,10309,330537,6813889
United Kingdom,2021-04-27,356446,10781,345665,7131319
United Kingdom,2021-04-28,372245,11259,360986,7449672
United Kingdom,2021-04-29,389494,11780,377714,7768932
United Kingdom,2021-04-30,404567,12236,392331,8089082
United Kingdom,2021-05-01,421392,12745,408647,8410106
United Kingdom,2021-05-02,438045,13249,424796,8731987
United Kingdom,2021-05-03,453814,13726,440088,9054708
United Kingdom,2021-05-04,469884,14212,455672,9378253
United Kingdom,2021-05-05,485251,14677,470574,9702604
United Kingdom,2021-05-06,501093,15156,485937,10027745
United Kingdom,2021-05-07,519183,15703,503480,10353658
United Kingdom,2021-05-08,534290,16160,518130,10680326
United Kingdom,2021-05-09,551711,16687,535024,11007732
United Kingdom,2021-05-10,566904,17147,549757,11335859
United Kingdom,2021-05-11,584207,17670,566537,11664688
United Kingdom,2021-05-12,600986,18177,582809,11994202
United Kingdom,2021-05-13,616250,18639,597611,12324384
United Kingdom,2021-05-14,633745,19168,614577,12655216
United Kingdom,2021-05-15,650145,19664,630481,12986680
United Kingdom,2021-05-16,668053,20206,647847,13318758
United Kingdom,2021-05-17,682549,20644,661905,13651432
United Kingdom,2021-05-18,699308,21151,678157,13984683
United Kingdom,2021-05-19,716563,21673,694890,14318494
United Kingdom,2021-05-20,734332,22211,712121,14652846
United Kingdom,2021-05-21,749228,22661,726567,14987721
United Kingdom,2021-05-22,767281,23207,744074,15323101
United Kingdom,2021-05-23,783940,23711,760229,15658966
United Kingdom,2021-05-24,798889,24163,774726,15995299
United Kingdom,2021-05-25,817786,24735,793051,16332080
United Kingdom,2021-05-26,833675,25216,808459,16669291
United Kingdom,2021-05-27,850688,25730,824958,17006913
United Kingdom,2021-05-28,867715,26245,841470,17344927
United Kingdom,2021-05-29,884717,26759,857958,17683314
United Kingdom,2021-05-30,901599,27270,874329,18022055
United Kingdom,2021-05-31,918633,27785,890848,18361131
United Kingdom,2021-06-01,935831,28305,907526,18700522
United Kingdom,2021-06-02,951763,28787,922976,19040210
United Kingdom,2021-06-03,970687,29360,941327,19380174
United Kingdom,2021-06-04,986122,29827,956295,19720396
United Kingdom,2021-06-05,1003289,30346,972943,20060856
United Kingdom,2021-06-06,1020415,30864,989551,20401535
United Kingdom,2021-06-07,1037183,31371,1005812,20742412
United Kingdom,2021-06-08,1055065,31912,1023153,21083468
United Kingdom,2021-06-09,1073339,32465,1040874,21424684
United Kingdom,2021-06-10,1089195,32944,1056251,21766039
United Kingdom,2021-06-11,1106900,33480,1073420,22107515
United Kingdom,2021-06-12,1123810,33991,1089819,22449089
United Kingdom,2021-06-13,1141246,34519,1106727,22790744
United Kingdom,2021-06-14,1157819,35020,1122799,23132458
United Kingdom,2021-06-15,1174995,35539,1139456,23474213
United Kingdom,2021-06-16,1193299,36093,1157206,23815986
United Kingdom,2021-06-17,1208305,36547,1171758,24157759
United Kingdom,2021-06-18,1224367,37033,1187334,24499511
United Kingdom,2021-06-19,1242554,37583,1204971,24841221
United Kingdom,2021-06-20,1260192,38116,1222076,25182870
United Kingdom,2021-06-21,1277176,38630,1238546,25524437
United Kingdom,2021-06-22,1294503,39154,1255349,25865902
United Kingdom,2021-06-23,1311229,39660,1271569,26207243
United Kingdom,2021-06-24,1328381,40179,1288202,26548441
United Kingdom,2021-06-25,1345984,40711,1305273,26889475
United Kingdom,2021-06-26,1361318,41175,1320143,27230323
United Kingdom,2021-06-27,1380507,41755,1338752,27570967
United Kingdom,2021-06-28,1396035,42225,1353810,27911384
United Kingdom,2021-06-29,1413605,42757,1370848,28251554
United Kingdom,2021-06-30,1429245,43230,1386015,28591457
United Kingdom,2021-07-01,1447290,43775,1403515,28931071
United Kingdom,2021-07-02,1464735,44303,1420432,29270375
United Kingdom,2021-07-03,1481611,44813,1436798,29609349
United Kingdom,2021-07-04,1498351,45320,1453031,29947972
United Kingdom,2021-07-05,1516070,45856,1470214,30286223
United Kingdom,2021-07-06,1532712,46359,1486353,30624080
United Kingdom,2021-07-07,1550278,46890,1503388,30961523
United Kingdom,2021-07-08,1566547,47383,1519164,31298531
United Kingdom,2021-07-09,1582687,47871,1534816,31635082
United Kingdom,2021-07-10,1599354,48375,1550979,31971155
United Kingdom,2021-07-11,1617683,48929,1568754,32306730
United Kingdom,2021-07-12,1633188,49398,1583790,32641785
United Kingdom,2021-07-13,1649441,49890,1599551,32976299
United Kingdom,2021-07-14,1666634,50410,1616224,33310251
United Kingdom,2021-07-15,1683624,50924,1632700,33643619
United Kingdom,2021-07-16,1700114,51423,1648691,33976383
United Kingdom,2021-07-17,1716810,51928,1664882,34308521
United Kingdom,2021-07-18,1733452,52431,1681021,34640011
United Kingdom,2021-07-19,1749444,52915,1696529,34970833
United Kingdom,2021-07-20,1764504,53370,1711134,35300965
United Kingdom,2021-07-21,1783048,53931,1729117,35630386
United Kingdom,2021-07-22,1799195,54419,1744776,35959074
United Kingdom,2021-07-23,1815412,54910,1760502,36287008
United Kingdom,2021-07-24,1832202,55418,1776784,36614168
United Kingdom,2021-07-25,1847309,55875,1791434,36940530
United Kingdom,2021-07-26,1865942,56438,1809504,37266075
United Kingdom,2021-07-27,1880929,56892,1824037,37590781
United Kingdom,2021-07-28,1896206,57354,1838852,37914626
United Kingdom,2021-07-29,1913109,57865,1855244,38237589
United Kingdom,2021-07-30,1929570,58363,1871207,38559649
United Kingdom,2021-07-31,1944770,58823,1885947,38880784
United Kingdom,2021-08-01,1960464,59297,1901167,39200972
United Kingdom,2021-08-02,1976897,59794,1917103,39520194
United Kingdom,2021-08-03,1993495,60296,1933199,39838426
United Kingdom,2021-08-04,2008502,60750,1947752,40155649
United Kingdom,2021-08-05,2024894,61246,1963648,40471840
United Kingdom,2021-08-06,2039871,61699,1978172,40786978
United Kingdom,2021-08-07,2055072,62159,1992913,41101042
United Kingdom,2021-08-08,2073495,62716,2010779,41414010
United Kingdom,2021-08-09,2087243,63132,2024111,41725861
United Kingdom,2021-08-10,2104031,63640,2040391,42036575
United Kingdom,2021-08-11,2116671,64022,2052649,42346129
United Kingdom,2021-08-12,2134064,64548,2069516,42654502
United Kingdom,2021-08-13,2148596,64988,2083608,42961674
United Kingdom,2021-08-14,2164422,65466,2098956,43267622
United Kingdom,2021-08-15,2180177,65943,2114234,43572326
United Kingdom,2021-08-16,2195427,66404,2129023,43875765
United Kingdom,2021-08-17,2208830,66810,2142020,44177917
United Kingdom,2021-08-18,2224298,67277,2157021,44478761
United Kingdom,2021-08-19,2238601,67710,2170891,44778277
United Kingdom,2021-08-20,2254788,68200,2186588,45076442
United Kingdom,2021-08-21,2269467,68644,2200823,45373236
United Kingdom,2021-08-22,2284612,69102,2215510,45668639
United Kingdom,2021-08-23,2299322,69547,2229775,45962628
United Kingdom,2021-08-24,2314459,70004,2244455,46255183
United Kingdom,2021-08-25,2328246,70421,2257825,46546283
United Kingdom,2021-08-26,2343317,70877,2272440,46835908
United Kingdom,2021-08-27,2356884,71288,2285596,47124036
United Kingdom,2021-08-28,2371396,71727,2299669,47410646
United Kingdom,2021-08-29,2385566,72155,2313411,47695718
United Kingdom,2021-08-30,2398796,72555,2326241,47979231
United Kingdom,2021-08-31,2414052,73017,2341035,48261164
United Kingdom,2021-09-01,2427525,73424,2354101,48541497
United Kingdom,2021-09-02,2440578,73819,2366759,48820208
United Kingdom,2021-09-03,2454933,74253,2380680,49097279
United Kingdom,2021-09-04,2468803,74673,2394130,49372687
United Kingdom,2021-09-05,2483476,75117,2408359,49646412
United Kingdom,2021-09-06,2496708,75517,2421191,49918435
United Kingdom,2021-09-07,2511270,75957,2435313,50188734
United Kingdom,2021-09-08,2523459,76326,2447133,50457289
United Kingdom,2021-09-09,2536946,76734,2460212,50724081
United Kingdom,2021-09-10,2550362,77140,2473222,50989088
United Kingdom,2021-09-11,2562836,77517,2485319,51252291
United Kingdom,2021-09-12,2577417,77958,2499459,51513669
United Kingdom,2021-09-13,2588459,78292,2510167,51773203
United Kingdom,2021-09-14,2601834,78697,2523137,52030873
United Kingdom,2021-09-15,2615278,79103,2536175,52286658
United Kingdom,2021-09-16,2628020,79489,2548531,52540539
United Kingdom,2021-09-17,2640185,79857,2560328,52792496
United Kingdom,2021-09-18,2651974,80213,2571761,53042509
United Kingdom,2021-09-19,2665334,80617,2584717,53290558
United Kingdom,2021-09-20,2677603,80988,2596615,53536625
United Kingdom,2021-09-21,2689885,81360,2608525,53780689
United Kingdom,2021-09-22,2700784,81690,2619094,54022731
United Kingdom,2021-09-23,2714238,82097,2632141,54262731
United Kingdom,2021-09-24,2725898,82449,2643449,54500671
United Kingdom,2021-09-25,2736671,82775,2653896,54736531
United Kingdom,2021-09-26,2749247,83155,2666092,54970291
United Kingdom,2021-09-27,2760150,83485,2676665,55201933
United Kingdom,2021-09-28,2773009,83874,2689135,55431438
United Kingdom,2021-09-29,2783891,84203,2699688,55658787
United Kingdom,2021-09-30,2793996,84509,2709487,55883961
United Kingdom,2021-10-01,2806605,84890,2721715,56106941
United Kingdom,2021-10-02,2817280,85213,2732067,56327708
United Kingdom,2021-10-03,2827923,85535,2742388,56546245
United Kingdom,2021-10-04,2839576,85888,2753688,56762531
United Kingdom,2021-10-05,2849879,86199,2763680,56976550
United Kingdom,2021-10-06,2860101,86508,2773593,57188282
United Kingdom,2021-10-07,2870610,86826,2783784,57397710
United Kingdom,2021-10-08,2880120,87114,2793006,57604814
United Kingdom,2021-10-09,2890174,87418,2802756,57809578
United Kingdom,2021-10-10,2901914,87773,2814141,58011983
United Kingdom,2021-10-11,2911251,88056,2823195,58212011
United Kingdom,2021-10-12,2920743,88343,2832400,58409645
United Kingdom,2021-10-13,2929925,88620,2841305,58604866
United Kingdom,2021-10-14,2940098,88928,2851170,58797658
United Kingdom,2021-10-15,2949898,89224,2860674,58988002
United Kingdom,2021-10-16,2959029,89501,2869528,59175881
United Kingdom,2021-10-17,2968286,89781,2878505,59361278
United Kingdom,2021-10-18,2978510,90090,2888420,59544176
United Kingdom,2021-10-19,2986760,90339,2896421,59724558
United Kingdom,2021-10-20,2994785,90582,2904203,59902406
United Kingdom,2021-10-21,3004673,90881,2913792,60077704
United Kingdom,2021-10-22,3013072,91135,2921937,60250435
United Kingdom,2021-10-23,3021824,91400,2930424,60420583
United Kingdom,2021-10-24,3031599,91696,2939903,60588130
United Kingdom,2021-10-25,3038253,91897,2946356,60753061
United Kingdom,2021-10-26,3046168,92136,2954032,60915359
United Kingdom,2021-10-27,3054695,92394,2962301,61075007
United Kingdom,2021-10-28,3062971,92645,2970326,61231991
United Kingdom,2021-10-29,3070492,92872,2977620,61386293
United Kingdom,2021-10-30,3076947,93067,2983880,61537897
United Kingdom,2021-10-31,3083562,93267,2990295,61686789
United Kingdom,2021-11-01,3091262,93500,2997762,61832953
United Kingdom,2021-11-02,3100276,93773,3006503,61976372
United Kingdom,2021-11-03,3105807,93940,3011867,62117032
United Kingdom,2021-11-04,3113723,94180,3019543,62254918
United Kingdom,2021-11-05,3120414,94382,3026032,62390013
United Kingdom,2021-11-06,3126938,94579,3032359,62522304
United Kingdom,2021-11-07,3132609,94751,3037858,62651775
United Kingdom,2021-11-08,3138760,94937,3043823,62778411
United Kingdom,2021-11-09,3145658,95146,3050512,62902198
United Kingdom,2021-11-10,3151684,95328,3056356,63023122
United Kingdom,2021-11-11,3157207,95495,3061712,63141167
United Kingdom,2021-11-12,3162885,95667,3067218,63256320
United Kingdom,2021-11-13,3168075,95824,3072251,63368567
United Kingdom,2021-11-14,3175203,96039,3079164,63477894
United Kingdom,2021-11-15,3179628,96173,3083455,63584286
United Kingdom,2021-11-16,3185529,96352,3089177,63687730
United Kingdom,2021-11-17,3189854,96482,3093372,63788213
United Kingdom,2021-11-18,3194839,96633,3098206,63885720
United Kingdom,2021-11-19,3199434,96772,3102662,63980240
United Kingdom,2021-11-20,3204512,96926,3107586,64071758
United Kingdom,2021-11-21,3209394,97073,3112321,64160262
United Kingdom,2021-11-22,3214071,97215,3116856,64245738
United Kingdom,2021-11-23,3216851,97299,3119552,64328174
United Kingdom,2021-11-24,3221014,97425,3123589,64407558
United Kingdom,2021-11-25,3224987,97545,3127442,64483876
United Kingdom,2021-11-26,3227283,97614,3129669,64557117
United Kingdom,2021-11-27,3232262,97765,3134497,64627269
United Kingdom,2021-11-28,3234060,97819,3136241,64694319
United Kingdom,2021-11-29,3237107,97912,3139195,64758255
United Kingdom,2021-11-30,3242565,98077,3144488,64819067
United Kingdom,2021-12-01,3244052,98122,3145930,64876742
United Kingdom,2021-12-02,3247103,98214,3148889,64931268
United Kingdom,2021-12-03,3251367,98343,3153024,64982636
United Kingdom,2021-12-04,3252772,98385,3154387,65030833
United Kingdom,2021-12-05,3253506,98408,3155098,65075849
United Kingdom,2021-12-06,3254743,98445,3156298,65117672
United Kingdom,2021-12-07,3257423,98526,3158897,65156293
United Kingdom,2021-12-08,3259577,98591,3160986,65191700
United Kingdom,2021-12-09,3261411,98647,3162764,65223884
United Kingdom,2021-12-10,3261692,98655,3163037,65252834
United Kingdom,2021-12-11,3262652,98684,3163968,65278541
United Kingdom,2021-12-12,3265622,98774,3166848,65300994
United Kingdom,2021-12-13,3267532,98832,3168700,65320183
United Kingdom,2021-12-14,3268385,98858,3169527,65336100
United Kingdom,2021-12-15,3266685,98806,3167879,65348735
United Kingdom,2021-12-16,3268073,98848,3169225,65358079
United Kingdom,2021-12-17,3268209,98852,3169357,65364122
United Kingdom,2021-12-18,3269676,98897,3170779,65366856
United Kingdom,2021-12-19,3268934,98874,3170060,65366272
United Kingdom,2021-12-20,3268418,98859,3169559,65362362
United Kingdom,2021-12-21,3267705,98837,3168868,65355117
United Kingdom,2021-12-22,3267578,98833,3168745,65344530
United Kingdom,2021-12-23,3267306,98825,3168481,65330591
United Kingdom,2021-12-24,3266260,98793,3167467,65313293
United Kingdom,2021-12-25,3263865,98721,3165144,65292629
United Kingdom,2021-12-26,3263308,98704,3164604,65268592
United Kingdom,2021-12-27,3261679,98655,3163024,65241173
United Kingdom,2021-12-28,3261155,98639,3162516,65210365
United Kingdom,2021-12-29,3260831,98629,3162202,65176162
United Kingdom,2021-12-30,3257291,98522,3158769,65138557
United Kingdom,2021-12-31,3255465,98467,3156998,65097543
